tsebe	ts> E b E
melatong	m E l a t> O N
selebalo	s E l E b a l O
fitlhelwe	f i tlh E l w E
bologamaano	b O l O x a m a n O
patlisiso	p> a tl> i s i s O
tlhokomeleng	tlh O k> O m E l E N
boratšhe	b O r a tSh E
metswe	m E ts> w E
koporo	k> O p> O r O
bulegileng	b u l E x i l E N
molotlhanyi	m O l O tlh a J i
makeišeneng	m a k> E i S E n E N
goboka	x O b O k> a
rerang	r E r a N
dikolobe	d i k> O l O b E
robetswe	r O b E ts> w E
itlhaotseng	i tlh a O ts> E N
ntsoma	n ts> O m a
ipatlelang	i p> a tl> E l a N
rute	r u t> E
mmiletsang	m m i l E ts> a N
lepalepane	l E p> a l E p> a n E
molaleng	m O l a l E N
gile	x i l E
lekola	l E k> O l a
dipoleo	d i p> O l E O
mapetla	m a p> E tl> a
phaposi	ph a p> O s i
gatoga	x a t> O x a
thatafaletsang	th a t> a f a l E ts> a N
dibalate	d i b a l a t> E
mosidi	m O s i d i
tshwaeditsweng	tsh w a E d i ts> w E N
ntshwa	n tsh w a
mofetoleding	m O f E t> O l E d i N
kgodisa	kx O d i s a
pakiwang	p> a k> i w a N
kgaotsong	kx a O ts> O N
bontsi	b O n ts> i
sekaseke	s E k> a s E k> E
tloseng	tl> O s E N
tlhalo	tlh a l O
lebanta	l E b a n t> a
tlhoro	tlh O r O
rebolelang	r E b O l E l a N
adimilwe	a d i m i l w E
sekeresete	s E k> E r E s E t> E
pheto	ph E t> O
gannye	x a n J E
toloki	t> O l O k> i
otlhe	O tlh E
basimanyana	b a s i m a J a n a
kobotlong	k> O b O tl> O N
bogodung	b O x O d u N
ipaya	i p> a j a
kwadiwang	k> w a d i w a N
akanyetswa	a k> a J E ts> w a
thulano	th u l a n O
rulaganeng	r u l a x a n E N
botsa	b O ts> a
meleng	m E l E N
bobatlisisi	b O b a tl> i s i s i
atlhotse	a tlh O ts> E
thaa	th a a
bannaleseabeng	b a n n a l E s E a b E N
tseleng	ts> E l E N
bosetlha	b O s E tlh a
tsibogele	ts> i b O x E l E
tlhangwang	tlh a N w a N
inaakanye	i n a k> a J E
lokologe	l O k> O l O x E
polotiki	p> O l O t> i k> i
kang	k> a N
tlhaolesegileng	tlh a O l E s E x i l E N
kgora	kx O r a
mothomolaong	m O th O m O l a O N
babolai	b a b O l a i
ditlamo	d i tl> a m O
tshisimogo	tsh i s i m O x O
boboa	b O b O a
itatlhela	i t> a tlh E l a
tsibositse	ts> i b O s i ts> E
bakileng	b a k> i l E N
legotlo	l E x O tl> O
tlhalosega	tlh a l O s E x a
senole	s E n O l E
pusoselegaeng	p> u s O s E l E x a E N
dithunyi	d i th u J i
boitshega	b O i tsh E x a
ditlamoragong	d i tl> a m O r a x O N
rutiwe	r u t> i w E
tloswe	tl> O s w E
tsokaneng	ts> O k> a n E N
thomelontle	th O m E l O n tl> E
fudusa	f u d u s a
lefelwa	l E f E l w a
phepafadiwe	ph E p> a f a d i w E
sephiri	s E ph i r i
togamaano	t> O x a m a n O
selwaneng	s E l w a n E N
mometsong	m O m E ts> O N
gapeletsega	x a p> E l E ts> E x a
katlholelopele	k> a tlh O l E l O p> E l E
morwae	m O r w a E
mmannete	m m a n n E t> E
tshwarisa	tsh w a r i s a
kganeloketso	kx a n E l O k> E ts> O
sengwaga	s E N w a x a
kgabagare	kx a b a x a r E
kgaitsadie	kx a i ts> a d i E
tlwaelo	tl> w a E l O
dumelwa	d u m E l w a
difitlholo	d i f i tlh O l O
tlhokafalelang	tlh O k> a f a l E l a N
tiisetsong	t> i i s E ts> O N
bakiwa	b a k> i w a
phunyegileng	ph u J E x i l E N
tlhapileng	tlh a p> i l E N
dumelanwa	d u m E l a n w a
apotse	a p> O ts> E
dišere	d i S E r E
batlhabani	b a tlh a b a n i
diphelelo	d i ph E l E l O
bofofu	b O f O f u
kwadiso	k> w a d i s O
tonatona	t> O n a t> O n a
bogotlhe	b O x O tlh E
leba	l E b a
gaisitse	x a i s i ts> E
legoleng	l E x O l E N
dinamaneng	d i n a m a n E N
tšhotlhatšhotlha	tSh O tlh a tSh O tlh a
gobea	x O b E a
itswela	i ts> w E l a
dulang	d u l a N
phokotsong	ph O k> O ts> O N
rwalwang	r w a l w a N
molebeledi	m O l E b E l E d i
iketletse	i k> E tl> E ts> E
lomepe	l O m E p> E
phasaladitswe	ph a s a l a d i ts> w E
diriwe	d i r i w E
mogolodi	m O x O l O d i
sentsi	s E n ts> i
maborogo	m a b O r O x O
mosotlegi	m O s O tl> E x i
polao	p> O l a O
teleletelele	t> E l E l E t> E l E l E
matsogong	m a ts> O x O N
diholong	d i h O l O N
dikantorong	d i k> a n t> O r O N
matlhale	m a tlh a l E
jotlhe	d0Z O tlh E
mongweng	m O N w E N
dikgakgamatso	d i kx a kx a m a ts> O
rothela	r O th E l a
pegong	p> E x O N
bolokeng	b O l O k> E N
babelegisi	b a b E l E x i s i
phegelwana	ph E x E l w a n a
lebogetse	l E b O x E ts> E
fetswang	f E ts> w a N
dirisetswang	d i r i s E ts> w a N
itlhopheleng	i tlh O ph E l E N
motlae	m O tl> a E
rukutlha	r u k> u tlh a
maetsi	m a E ts> i
methale	m E th a l E
gotele	x O t> E l E
lenyalo	l E J a l O
lebokosong	l E b O k> O s O N
tsia	ts> i a
gaeng	x a E N
namolo	n a m O l O
tsepametse	ts> E p> a m E ts> E
maipobolo	m a i p> O b O l O
mmakaditse	m m a k> a d i ts> E
dithulanong	d i th u l a n O N
adimisang	a d i m i s a N
segofaditswe	s E x O f a d i ts> w E
diranta	d i r a n t> a
itlhatswa	i tlh a ts> w a
nteletse	n t> E l E ts> E
mogobagoba	m O x O b a x O b a
tumallano	t> u m a l l a n O
emele	E m E l E
pontsho	p> O n tsh O
nala	n a l a
itirelwa	i t> i r E l w a
begetsweng	b E x E ts> w E N
etleediwe	E tl> E E d i w E
motsholamatlotlo	m O tsh O l a m a tl> O tl> O
malana	m a l a n a
akangwang	a k> a N w a N
masesane	m a s E s a n E
palameng	p> a l a m E N
tlhoriso	tlh O r i s O
lolapa	l O l a p> a
ithutang	i th u t> a N
metshamekong	m E tsh a m E k> O N
gakolotse	x a k> O l O ts> E
batlhatlhobing	b a tlh a tlh O b i N
rraagwe	r r a x w E
rutiwa	r u t> i w a
bokanakang	b O k> a n a k> a N
kgapetsakgapetsa	kx a p> E ts> a kx a p> E ts> a
kelo	k> E l O
setlhafetseng	s E tlh a f E ts> E N
khalentara	kh a l E n t> a r a
konotelela	k> O n O t> E l E l a
namola	n a m O l a
buisitse	b u i s i ts> E
leboneng	l E b O n E N
tlatsa	tl> a ts> a
jale	d0Z a l E
ganetsweng	x a n E ts> w E N
badiwa	b a d i w a
lekeleditswe	l E k> E l E d i ts> w E
lokologileng	l O k> O l O x i l E N
apeilweng	a p> E i l w E N
khurumediwa	kh u r u m E d i w a
dikgankhutshwe	d i kx a n kh u tsh w E
menagane	m E n a x a n E
boletswe	b O l E ts> w E
lekeišene	l E k> E i S E n E
letlheng	l E tlh E N
boratoropo	b O r a t> O r O p> O
sedimoseditsweng	s E d i m O s E d i ts> w E N
twatsi	ts> w a ts> i
fetileng	f E t> i l E N
siana	s i a n a
kitlaneng	k> i tl> a n E N
lofetlho	l O f E tlh O
itumeleleng	i t> u m E l E l E N
tsoswa	ts> O s w a
batshegetsing	b a tsh E x E ts> i N
fularela	f u l a r E l a
eteletswe	E t> E l E ts> w E
ditlhale	d i tlh a l E
tšhentšha	tSh E n tSh a
tokafadiwe	t> O k> a f a d i w E
manganga	m a N a N a
tlotlwe	tl> O tl> w E
dirasiti	d i r a s i t> i
phothega	ph O th E x a
tengteng	t> E N t> E N
motlanyi	m O tl> a J i
bofologa	b O f O l O x a
tshepe	tsh E p> E
tlhaoletsweng	tlh a O l E ts> w E N
kabang	k> a b a N
dueleleng	d u E l E l E N
ntšhwafatsong	n tSh w a f a ts> O N
tshimologo	tsh i m O l O x O
ikgatholosiwang	i kx a th O l O s i w a N
mafokomašwa	m a f O k> O m a S w a
logetsa	l O x E ts> a
itidimaletseng	i t> i d i m a l E ts> E N
masetlapelo	m a s E tl> a p> E l O
fitlhelweng	f i tlh E l w E N
gakaletseng	x a k> a l E ts> E N
rerisiwa	r E r i s i w a
ditekanyong	d i t> E k> a J O N
phepafaditse	ph E p> a f a d i ts> E
bafaladi	b a f a l a d i
dutse	d u ts> E
rakagiso	r a k> a x i s O
morwadiabone	m O r w a d i a b O n E
tsabakelang	ts> a b a k> E l a N
thibele	th i b E l E
saennweng	s a E n n w E N
kamore	k> a m O r E
tlhang	tlh a N
neelanang	n E E l a n a N
diphefo	d i ph E f O
akgelwe	a kx E l w E
ikanetsweng	i k> a n E ts> w E N
tshegediwe	tsh E x E d i w E
dikgolokgolo	d i kx O l O kx O l O
mona	m O n a
modi	m O d i
itshukunyeditse	i tsh u k> u J E d i ts> E
utlweletse	u tl> w E l E ts> E
ikutlwela	i k> u tl> w E l a
dirente	d i r E n t> E
dipharologano	d i ph a r O l O x a n O
pusoselegae	p> u s O s E l E x a E
kgotletswe	kx O tl> E ts> w E
thujwa	th u d0Z w a
mogaka	m O x a k> a
nyalo	J a l O
itshwere	i tsh w E r E
fetang	f E t> a N
jalelwa	d0Z a l E l w a
matshediso	m a tsh E d i s O
seatleng	s E a tl> E N
sotlega	s O tl> E x a
tlhomamisege	tlh O m a m i s E x E
tlhaloganyana	tlh a l O x a J a n a
disusu	d i s u s u
mmotlolo	m m O tl> O l O
boitiso	b O i t> i s O
ditshesane	d i tsh E s a n E
thito	th i t> O
betsegele	b E ts> E x E l E
phatlalala	ph a tl> a l a l a
ikitsisitse	i k> i ts> i s i ts> E
bodila	b O d i l a
matlwang	m a tl> w a N
motseleganyi	m O ts> E l E x a J i
tliswa	tl> i s w a
dipholesi	d i ph O l E s i
palelong	p> a l E l O N
monagano	m O n a x a n O
kitsisong	k> i ts> i s O N
makalo	m a k> a l O
maatlafatsong	m a tl> a f a ts> O N
mothong	m O th O N
tšhwetlegileng	tSh w E tl> E x i l E N
kobetsweng	k> O b E ts> w E N
batlelwe	b a tl> E l w E
setlwaedi	s E tl> w a E d i
peelano	p> E E l a n O
kgati	kx a t> i
maitseboa	m a i ts> E b O a
kgaolelweng	kx a O l E l w E N
lekelelwa	l E k> E l E l w a
kgetholola	kx E th O l O l a
mokgona	m O kx O n a
swele	s w E l E
ritibatsa	r i t> i b a ts> a
temong	t> E m O N
lelediwa	l E l E d i w a
hisetori	h i s E t> O r i
romeletsa	r O m E l E ts> a
itlhophelo	i tlh O ph E l O
kgwediso	kx w E d i s O
molaetseng	m O l a E ts> E N
khompiutara	kh O m p> i u t> a r a
arabisanya	a r a b i s a J a
bidiwa	b i d i w a
bopileng	b O p> i l E N
sejo	s E d0Z O
senyetse	s E J E ts> E
bankang	b a n k> a N
boromiwang	b O r O m i w a N
gopolwang	x O p> O l w a N
poposešwa	p> O p> O s E S w a
metsu	m E ts> u
rulaganngwe	r u l a x a n N w E
ditsheng	d i tsh E N
mmopi	m m O p> i
morwarraago	m O r w a r r a x O
ganediwang	x a n E d i w a N
lekanyeditsweng	l E k> a J E d i ts> w E N
amogelesegeng	a m O x E l E s E x E N
karolelo	k> a r O l E l O
sajene	s a d0Z E n E
dipotlana	d i p> O tl> a n a
kgatlhegelong	kx a tlh E x E l O N
tirelopusong	t> i r E l O p> u s O N
tsenyetsa	ts> E J E ts> a
tlalong	tl> a l O N
lebotlolong	l E b O tl> O l O N
ngongoregisiwang	N O N O r E x i s i w a N
modula	m O d u l a
lefika	l E f i k> a
bapa	b a p> a
kgopolola	kx O p> O l O l a
seraleng	s E r a l E N
tlhapise	tlh a p> i s E
tlholelo	tlh O l E l O
semeletse	s E m E l E ts> E
fitlhella	f i tlh E l l a
tikologo	t> i k> O l O x O
kgoeletso	kx O E l E ts> O
mmone	m m O n E
tlhamalala	tlh a m a l a l a
sepalamo	s E p> a l a m O
ikanne	i k> a n n E
tumisa	t> u m i s a
kgomana	kx O m a n a
bafeti	b a f E t> i
dialo	d i a l O
direlanang	d i r E l a n a N
lesela	l E s E l a
letlhoding	l E tlh O d i N
tetelo	t> E t> E l O
tshwaelwe	tsh w a E l w E
dikerii	d i k> E r i i
senkela	s E n k> E l a
itumetse	i t> u m E ts> E
tshelang	tsh E l a N
motshameko	m O tsh a m E k> O
itseela	i ts> E E l a
ikgatolosa	i kx a t> O l O s a
tsetswe	ts> E ts> w E
batlhatlhobi	b a tlh a tlh O b i
umakilwe	u m a k> i l w E
diikokotlelo	d i i k> O k> O tl> E l O
mmuaesi	m m u a E s i
dijenaleng	d i d0Z E n a l E N
bodipolomate	b O d i p> O l O m a t> E
lebalwa	l E b a l w a
buisega	b u i s E x a
ntlotlile	n tl> O tl> i l E
amogelesege	a m O x E l E s E x E
tsamaise	ts> a m a i s E
tshwenngwang	tsh w E n N w a N
beeletse	b E E l E ts> E
motlatsamokaedi	m O tl> a ts> a m O k> a E d i
itseweng	i ts> E w E N
marapo	m a r a p> O
sekeletsa	s E k> E l E ts> a
tlhomamiseng	tlh O m a m i s E N
makgwakgwa	m a kx w a kx w a
neeletsana	n E E l E ts> a n a
semeleleng	s E m E l E l E N
tlhabela	tlh a b E l a
mpolaya	m p> O l a j a
motshabi	m O tsh a b i
ledile	l E d i l E
motsoko	m O ts> O k> O
ganelwa	x a n E l w a
kamogelo	k> a m O x E l O
phuthaphutha	ph u th a ph u th a
bonelweng	b O n E l w E N
boikuelong	b O i k> u E l O N
nkgonne	n kx O n n E
mmangwane	m m a N w a n E
ditoropong	d i t> O r O p> O N
itsose	i ts> O s E
mokawana	m O k> a w a n a
bosilo	b O s i l O
iketlile	i k> E tl> i l E
tshegisa	tsh E x i s a
maremo	m a r E m O
lemosegang	l E m O s E x a N
bule	b u l E
inthaneteng	i n th a n E t> E N
ikabetseng	i k> a b E ts> E N
mafulo	m a f u l O
tshukudu	tsh u k> u d u
morunikakaretso	m O r u n i k> a k> a r E ts> O
goroge	x O r O x E
tirisodikgoka	t> i r i s O d i kx O k> a
nkgakile	n kx a k> i l E
sekontari	s E k> O n t> a r i
thubaganya	th u b a x a J a
bakoping	b a k> O p> i N
huhumele	h u h u m E l E
tlhoma	tlh O m a
tlhatlogong	tlh a tl> O x O N
dingwaong	d i N w a O N
tebagano	t> E b a x a n O
diragala	d i r a x a l a
bolela	b O l E l a
borepurepu	b O r E p> u r E p> u
dimakatso	d i m a k> a ts> O
dinako	d i n a k> O
kgotsofaletse	kx O ts> O f a l E ts> E
bothapi	b O th a p> i
kolofo	k> O l O f O
hutsafetse	h u ts> a f E ts> E
bosakhutleng	b O s a kh u tl> E N
phophotha	ph O ph O th a
dikopi	d i k> O p> i
tsweledisiwa	ts> w E l E d i s i w a
hudusiwa	h u d u s i w a
mponeng	m p> O n E N
thamong	th a m O N
sejatlhapi	s E d0Z a tlh a p> i
diholo	d i h O l O
lefaufaung	l E f a u f a u N
rolela	r O l E l a
tsamaisanang	ts> a m a i s a n a N
seleng	s E l E N
tlhamalatsa	tlh a m a l a ts> a
tshosetsang	tsh O s E ts> a N
dithupa	d i th u p> a
mmatlela	m m a tl> E l a
ditlhogong	d i tlh O x O N
ikgatholose	i kx a th O l O s E
tshwaraganye	tsh w a r a x a J E
tlholwa	tlh O l w a
tlamelo	tl> a m E l O
dithorong	d i th O r O N
lelele	l E l E l E
gotetsa	x O t> E ts> a
kaegang	k> a E x a N
mpitsang	m p> i ts> a N
tlotlomaletsa	tl> O tl> O m a l E ts> a
fatlhositsweng	f a tlh O s i ts> w E N
utswile	u ts> w i l E
adimisa	a d i m i s a
mariri	m a r i r i
balote	b a l O t> E
akanye	a k> a J E
tlaleleditsweng	tl> a l E l E d i ts> w E N
bula	b u l a
tlhamalatseng	tlh a m a l a ts> E N
dipeong	d i p> E O N
dikgosana	d i kx O s a n a
oketsege	O k> E ts> E x E
tlhotlhe	tlh O tlh E
dipharologanyo	d i ph a r O l O x a J O
letse	l E ts> E
akgolela	a kx O l E l a
bararo	b a r a r O
tlhaele	tlh a E l E
atlhole	a tlh O l E
ntsime	n ts> i m E
reediwang	r E E d i w a N
lepe	l E p> E
tlhatswege	tlh a ts> w E x E
barulaganyi	b a r u l a x a J i
kgathalatsege	kx a th a l a ts> E x E
tlhabiwang	tlh a b i w a N
suba	s u b a
okobatsang	O k> O b a ts> a N
felang	f E l a N
modira	m O d i r a
itshetlegileng	i tsh E tl> E x i l E N
didirisiweng	d i d i r i s i w E N
ikaleditse	i k> a l E d i ts> E
setlhogong	s E tlh O x O N
mela	m E l a
ikgantshang	i kx a n tsh a N
boitlhamelo	b O i tlh a m E l O
kgotlelelano	kx O tl> E l E l a n O
ntlong	n tl> O N
hirisetsa	h i r i s E ts> a
oketsega	O k> E ts> E x a
sedirwa	s E d i r w a
metsotswanang	m E ts> O ts> w a n a N
palonyana	p> a l O J a n a
ntlamparela	n tl> a m p> a r E l a
simololwang	s i m O l O l w a N
tlhabololwang	tlh a b O l O l w a N
robong	r O b O N
ipulelang	i p> u l E l a N
utlwisang	u tl> w i s a N
itirisang	i t> i r i s a N
boikokobetso	b O i k> O k> O b E ts> O
kanamiso	k> a n a m i s O
boikanyo	b O i k> a J O
semmusong	s E m m u s O N
dipharagobeng	d i ph a r a x O b E N
itatswe	i t> a ts> w E
kojwana	k> O d0Z w a n a
ditse	d i ts> E
tlhatlogela	tlh a tl> O x E l a
mosireletsi	m O s i r E l E ts> i
letleleleng	l E tl> E l E l E N
tshupatlotlo	tsh u p> a tl> O tl> O
tlhokafalo	tlh O k> a f a l O
eleletsa	E l E l E ts> a
modumedi	m O d u m E d i
khemisi	kh E m i s i
kampana	k> a m p> a n a
mmegi	m m E x i
bokoso	b O k> O s O
pheteletso	ph E t> E l E ts> O
dikgolegelo	d i kx O l E x E l O
tsweletsa	ts> w E l E ts> a
dikgatonyana	d i kx a t> O J a n a
kganya	kx a J a
teatere	t> E a t> E r E
intshwarela	i n tsh w a r E l a
saese	s a E s E
epelwe	E p> E l w E
dikatoloso	d i k> a t> O l O s O
bafalodi	b a f a l O d i
mmapeng	m m a p> E N
segile	s E x i l E
dikao	d i k> a O
setswe	s E ts> w E
kgorometse	kx O r O m E ts> E
welane	w E l a n E
metheong	m E th E O N
selekano	s E l E k> a n O
mosola	m O s O l a
bothekeniki	b O th E k> E n i k> i
temeng	t> E m E N
popegong	p> O p> E x O N
tlhakanetseng	tlh a k> a n E ts> E N
rutang	r u t> a N
dialefabete	d i a l E f a b E t> E
ditsong	d i ts> O N
bonwa	b O n w a
itekanetseng	i t> E k> a n E ts> E N
khomišeneng	kh O m i S E n E N
dipe	d i p> E
sekgowa	s E kx O w a
phirimelelwang	ph i r i m E l E l w a N
manaila	m a n a i l a
tlalatlalang	tl> a l a tl> a l a N
phemelo	ph E m E l O
mogomotsi	m O x O m O ts> i
bohutsana	b O h u ts> a n a
baeteledipele	b a E t> E l E d i p> E l E
boela	b O E l a
duedisitswe	d u E d i s i ts> w E
diperesente	d i p> E r E s E n t> E
dinnye	d i n J E
matsogo	m a ts> O x O
thupiso	th u p> i s O
gaeletswe	x a E l E ts> w E
ditaolong	d i t> a O l O N
baagi	b a x i
kgapetswe	kx a p> E ts> w E
mathe	m a th E
boradipolitiki	b O r a d i p> O l i t> i k> i
peleta	p> E l E t> a
thutatsela	th u t> a ts> E l a
masaleleng	m a s a l E l E N
potsotherisano	p> O ts> O th E r i s a n O
lefelo	l E f E l O
ditshwenyego	d i tsh w E J E x O
ditšhabeng	d i tSh a b E N
ipege	i p> E x E
thikitha	th i k> i th a
ikopisang	i k> O p> i s a N
lemogilweng	l E m O x i l w E N
fitlhelegang	f i tlh E l E x a N
kopelwa	k> O p> E l w a
ditena	d i t> E n a
ntshothwane	n tsh O th w a n E
tsweletswe	ts> w E l E ts> w E
fetse	f E ts> E
rre	r r E
tshupafelo	tsh u p> a f E l O
rerisa	r E r i s a
molatswaneng	m O l a ts> w a n E N
kgwetlho	kx w E tlh O
molatofadiwa	m O l a t> O f a d i w a
tsenelang	ts> E n E l a N
itharabologelwa	i th a r a b O l O x E l w a
mantlhontlho	m a n tlh O n tlh O
gamelwang	x a m E l w a N
moriti	m O r i t> i
bantle	b a n tl> E
inela	i n E l a
dintlhana	d i n tlh a n a
poeletso	p> O E l E ts> O
obega	O b E x a
gago	x a x O
setemokerasi	s E t> E m O k> E r a s i
tsiditsana	ts> i d i ts> a n a
somamabedinngwe	s O m a m a b E d i n N w E
setsong	s E ts> O N
pakajaanong	p> a k> a d0Z a n O N
tewang	t> E w a N
maitemogelo	m a i t> E m O x E l O
tswaya	ts> w a j a
mokoping	m O k> O p> i N
maikemisetso	m a i k> E m i s E ts> O
barataro	b a r a t> a r O
metswako	m E ts> w a k> O
belegela	b E l E x E l a
makwalong	m a k> w a l O N
itlhomile	i tlh O m i l E
yotlhelele	j O tlh E l E l E
setereke	s E t> E r E k> E
direga	d i r E x a
tshedimosetso	tsh E d i m O s E ts> O
goduma	x O d u m a
pateletsego	p> a t> E l E ts> E x O
ditshwaelo	d i tsh w a E l O
itlhokomela	i tlh O k> O m E l a
tlhotlheleditswe	tlh O tlh E l E d i ts> w E
bothakga	b O th a kx a
letswai	l E ts> w a i
emelana	E m E l a n a
rulagantswe	r u l a x a n ts> w E
kotame	k> O t> a m E
akgela	a kx E l a
fudusiwa	f u d u s i w a
bolokiwang	b O l O k> i w a N
mpelaetsa	m p> E l a E ts> a
potefolio	p> O t> E f O l i O
mero	m E r O
betswa	b E ts> w a
tlhabiwe	tlh a b i w E
ditlhatlogo	d i tlh a tl> O x O
sekgemetšhaneng	s E kx E m E tSh a n E N
tlaleletsang	tl> a l E l E ts> a N
netefatswang	n E t> E f a ts> w a N
aba	a b a
kotula	k> O t> u l a
lebati	l E b a t> i
ananngwa	a n a n N w a
sebokeng	s E b O k> E N
ntlela	n tl> E l a
lomeletsang	l O m E l E ts> a N
thaetsweng	th a E ts> w E N
phetsa	ph E ts> a
lohuma	l O h u m a
kgotletseng	kx O tl> E ts> E N
bolokegileng	b O l O k> E x i l E N
seaforikanse	s E a f O r i k> a n s E
itlhamele	i tlh a m E l E
pitsa	p> i ts> a
tlhotlha	tlh O tlh a
bontlhabongwe	b O n tlh a b O N w E
dineeletsano	d i n E E l E ts> a n O
dikoko	d i k> O k> O
malepelepe	m a l E p> E l E p> E
gasa	x a s a
ntata	n t> a t> a
botshwantshi	b O tsh w a n tsh i
tuediso	t> u E d i s O
dikgosigadi	d i kx O s i x a d i
barwadi	b a r w a d i
botlhokatiro	b O tlh O k> a t> i r O
atlegeng	a tl> E x E N
oketswa	O k> E ts> w a
dilense	d i l E n s E
sekhi	s E kh i
tsholole	tsh O l O l E
ithala	i th a l a
feditswe	f E d i ts> w E
rulaganang	r u l a x a n a N
marekelo	m a r E k> E l O
ditshwanelo	d i tsh w a n E l O
searabia	s E a r a b i a
dithepe	d i th E p> E
mmarakeng	m m a r a k> E N
gapeletsegang	x a p> E l E ts> E x a N
iteilwe	i t> E i l w E
thatanyana	th a t> a J a n a
seo	s E O
dikheibole	d i kh E i b O l E
sitlhololela	s i tlh O l O l E l a
oketsegang	O k> E ts> E x a N
tsalano	ts> a l a n O
motlamedi	m O tl> a m E d i
jetseng	d0Z E ts> E N
fetotsweng	f E t> O ts> w E N
mariga	m a r i x a
tlwaelesega	tl> w a E l E S E x a
gaisitseng	x a i s i ts> E N
kobilwe	k> O b i l w E
itshetlela	i tsh E tl> E l a
tsiediwa	ts> i E d i w a
tikologa	t> i k> O l O x a
tswileng	ts> w i l E N
baemeding	b a E m E d i N
bolelong	b O l E l O N
supilwe	s u p> i l w E
lekwalodikgang	l E k> w a l O d i kx a N
iphitlhelang	i ph i tlh E l a N
badiredi	b a d i r E d i
gogilwe	x O x i l w E
jala	d0Z a l a
monongwaga	m O n O N w a x a
boikemelanosi	b O i k> E m E l a n O s i
meditona	m E d i t> O n a
ditlhagisong	d i tlh a x i s O N
diranang	d i r a n a N
dintwa	d i n t> w a
hunyeditse	h u J E d i ts> E
latlha	l a tlh a
kalokalo	k> a l O k> a l O
letlega	l E tl> E x a
atamelana	a t> a m E l a n a
modikologo	m O d i k> O l O x O
bokhukhuntshwane	b O kh u kh u n tsh w a n E
hekeng	h E k> E N
faposiwang	f a p> O s i w a N
tlatlana	tl> a tl> a n a
belegweng	b E l E x w E N
mmentlele	m m E n tl> E l E
obamelwa	O b a m E l w a
kayang	k> a j a N
podi	p> O d i
itshenotse	i tsh E n O ts> E
dipolelwanakala	d i p> O l E l w a n a k> a l a
sampole	s a m p> O l E
mmuo	m m u O
dikadimo	d i k> a d i m O
folosetse	f O l O s E ts> E
letlhabaphefong	l E tlh a b a ph E f O N
tlhatswa	tlh a ts> w a
kgonega	kx O n E x a
kwalolole	k> w a l O l O l E
bagolo	b a x O l O
jeweng	d0Z E w E N
tokafatsa	t> O k> a f a ts> a
ditekolong	d i t> E k> O l O N
kwalong	k> w a l O N
poelomorago	p> O E l O m O r a x O
kotara	k> O t> a r a
theilwe	th E i l w E
molala	m O l a l a
bogolo	b O x O l O
dipatlelong	d i p> a tl> E l O N
bakilweng	b a k> i l w E N
itaaganya	i t> a x a J a
balala	b a l a l a
inaakantse	i n a k> a n ts> E
ineele	i n E E l E
konoseditse	k> O n O s E d i ts> E
sekgala	s E kx a l a
letshwaokgwebo	l E tsh w a O kx w E b O
bokgakga	b O kx a kx a
sedisisa	s E d i s i s a
bosetlabošweng	b O s E tl> a b O S w E N
lepeepee	l E p> E E p> E E
lokwalong	l O k> w a l O N
patlame	p> a tl> a m E
iphemela	i ph E m E l a
lebaganeng	l E b a x a n E N
tlhasetswe	tlh a s E ts> w E
retelelweng	r E t> E l E l w E N
bonagaleng	b O n a x a l E N
ditikatiko	d i t> i k> a t> i k> O
ithutana	i th u t> a n a
tswelang	ts> w E l a N
mmatla	m m a tl> a
ipotsa	i p> O ts> a
makwalodikgang	m a k> w a l O d i kx a N
moraba	m O r a b a
matlhatlhaga	m a tlh a tlh a x a
iphetole	i ph E t> O l E
dikhampaseng	d i kh a m p> a s E N
itoma	i t> O m a
difoleteng	d i f O l E t> E N
ditone	d i t> O n E
timiwa	t> i m i w a
modirakopo	m O d i r a k> O p> O
galo	x a l O
dienjene	d i E n d0Z E n E
mebotlana	m E b O tl> a n a
okeditseng	O k> E d i ts> E N
atlhotseng	a tlh O ts> E N
tlhagisitswe	tlh a x i s i ts> w E
emana	E m a n a
tladiwe	tl> a d i w E
nyelelong	J E l E l O N
tlhakantsuke	tlh a k> a n ts> u k> E
bodiba	b O d i b a
ipofa	i p> O f a
romelang	r O m E l a N
faboriki	f a b O r i k> i
humile	h u m i l E
diphitlhelelo	d i ph i tlh E l E l O
botshabelo	b O tsh a b E l O
neelano	n E E l a n O
tlhophololwa	tlh O ph O l O l w a
gopang	x O p> a N
tlhamaletse	tlh a m a l E ts> E
bagwe	b a x w E
thatafala	th a t> a f a l a
thetela	th E t> E l a
ipona	i p> O n a
mangana	m a N a n a
thusano	th u s a n O
monnanyana	m O n n a J a n a
ditlhokwa	d i tlh O k> w a
ikaegilwe	i k> a E x i l w E
kgomaretsa	kx O m a r E ts> a
nang	n a N
thomo	th O m O
lebisiwe	l E b i s i w E
agilwe	a x i l w E
godisang	x O d i s a N
nepileng	n E p> i l E N
tshepagale	tsh E p> a x a l E
sekhutlong	s E kh u tl> O N
mara	m a r a
otlile	O tl> i l E
batlileng	b a tl> i l E N
setena	s E t> E n a
sediriswa	s E d i r i s w a
ngapang	N a p> a N
bulegetse	b u l E x E ts> E
tshwaraganelo	tsh w a r a x a n E l O
sepesepe	s E p> E s E p> E
akabatsang	a k> a b a ts> a N
ratana	r a t> a n a
bogodu	b O x O d u
bonyane	b O J a n E
bolokile	b O l O k> i l E
fetolweng	f E t> O l w E N
seraro	s E r a r O
lemile	l E m i l E
mafelelong	m a f E l E l O N
tlaleletsong	tl> a l E l E ts> O N
kgobokaneng	kx O b O k> a n E N
tlhagotse	tlh a x O ts> E
gileng	x i l E N
dinong	d i n O N
buisanang	b u i s a n a N
itemela	i t> E m E l a
dibanka	d i b a n k> a
diala	d i a l a
rotloeditswe	r O tl> O E d i ts> w E
tolokela	t> O l O k> E l a
melaong	m E l a O N
morago	m O r a x O
kumolwa	k> u m O l w a
kutlwanong	k> u tl> w a n O N
rosi	r O s i
ananya	a n a J a
lekgabana	l E kx a b a n a
kgomane	kx O m a n E
mekgabiso	m E kx a b i s O
dikgatong	d i kx a t> O N
tshekatshekong	tsh E k> a tsh E k> O N
thibelelwe	th i b E l E l w E
malalediwa	m a l a l E d i w a
kalaka	k> a l a k> a
busetswa	b u s E ts> w a
dimao	d i m a O
maitlamo	m a i tl> a m O
senama	s E n a m a
lwantshang	l w a n tsh a N
dikgaolo	d i kx a O l O
tlhaolo	tlh a O l O
dirutegi	d i r u t> E x i
diantifone	d i a n t> i f O n E
tlhotlhelediwang	tlh O tlh E l E d i w a N
khurumeditswe	kh u r u m E d i ts> w E
lwale	l w a l E
kgopo	kx O p> O
mmogisa	m m O x i s a
adimetsweng	a d i m E ts> w E N
sekwang	s E k> w a N
lepeletseng	l E p> E l E ts> E N
kananyo	k> a n a J O
poelong	p> O E l O N
padimotse	p> a d i m O ts> E
kgakololo	kx a k> O l O l O
dithulano	d i th u l a n O
kotama	k> O t> a m a
tle	tl> E
mmolaela	m m O l a E l a
khupediwa	kh u p> E d i w a
letsholo	l E tsh O l O
itshupo	i tsh u p> O
netefaletsa	n E t> E f a l E ts> a
iphitlhele	i ph i tlh E l E
disele	d i s E l E
bolumu	b O l u m u
tswalelong	ts> w a l E l O N
iphepa	i ph E p> a
rara	r a r a
tlhapatsa	tlh a p> a ts> a
kgabele	kx a b E l E
lemina	l E m i n a
baeno	b a E n O
tlhome	tlh O m E
fantising	f a n t> i s i N
jalelwang	d0Z a l E l w a N
poifong	p> O i f O N
tlhobaetsang	tlh O b a E ts> a N
ikwadisetswang	i k> w a d i s E ts> w a N
lepotlapotla	l E p> O tl> a p> O tl> a
senolwang	s E n O l w a N
ditlhophong	d i tlh O ph O N
kgoko	kx O k> O
tlamang	tl> a m a N
ipolokela	i p> O l O k> E l a
phatlhana	ph a tlh a n a
naletsana	n a l E ts> a n a
nthekela	n th E k> E l a
pholosa	ph O l O s a
itsapa	i ts> a p> a
karologanyo	k> a r O l O x a J O
seterata	s E t> E r a t> a
dipego	d i p> E x O
ngangisano	N a N i s a n O
ikemisetsa	i k> E m i s E ts> a
senyege	s E J E x E
bophelong	b O ph E l O N
mmanape	m m a n a p> E
foreime	f O r E i m E
tlilwe	tl> i l w E
amogele	a m O x E l E
kgaogantswe	kx a O x a n ts> w E
itsane	i ts> a n E
beilwe	b E i l w E
emisediwa	E m i s E d i w a
begela	b E x E l a
ikobelwe	i k> O b E l w E
kgobokanyetsa	kx O b O k> a J E ts> a
mminong	m m i n O N
diphopholetso	d i ph O ph O l E ts> O
kgonwe	kx O n w E
mpampetse	m p> a m p> E ts> E
dinamelweng	d i n a m E l w E N
tlhalaneng	tlh a l a n E N
ribone	r i b O n E
bosomenngwe	b O s O m E n N w E
keetane	k> E E t> a n E
tšhupu	tSh u p> u
pompo	p> O m p> O
tshepo	tsh E p> O
ditlhopha	d i tlh O ph a
lebelelana	l E b E l E l a n a
botseno	b O ts> E n O
rekisediwa	r E k> i s E d i w a
kgonagalang	kx O n a x a l a N
yoobedi	j O O b E d i
titietse	t> i t> i E ts> E
melelwaneng	m E l E l w a n E N
logare	l O x a r E
lolameng	l O l a m E N
utlwane	u tl> w a n E
nayo	n a j O
mmontshitse	m m O n tsh i ts> E
kgethegileng	kx E th E x i l E N
wetseng	w E ts> E N
dipompo	d i p> O m p> O
sekhutshwane	s E kh u tsh w a n E
gatsetsang	x a ts> E ts> a N
mafudisong	m a f u d i s O N
titiela	t> i t> i E l a
lekgotlanyana	l E kx O tl> a J a n a
kgatako	kx a t> a k> O
batla	b a tl> a
ntshofadiwa	n tsh O f a d i w a
rebotswe	r E b O ts> w E
adimisanang	a d i m i s a n a N
seane	s E a n E
tlhatlositsweng	tlh a tl> O s i ts> w E N
gakololwa	x a k> O l O l w a
diboko	d i b O k> O
iphemele	i ph E m E l E
peleng	p> E l E N
segolwane	s E x O l w a n E
bakganni	b a kx a n n i
kwadisiwa	k> w a d i s i w a
arabe	a r a b E
bueletse	b u E l E ts> E
boitebo	b O i t> E b O
dipolantereng	d i p> O l a n t> E r E N
ditlhopheng	d i tlh O ph E N
dikelo	d i k> E l O
bogautshwaneng	b O x a u tsh w a n E N
molemong	m O l E m O N
begwa	b E x w a
okomele	O k> O m E l E
pesalema	p> E s a l E m a
dikanedi	d i k> a n E d i
mebaraka	m E b a r a k> a
meepo	m E E p> O
sepane	s E p> a n E
tswakanye	ts> w a k> a J E
pampiritshweu	p> a m p> i r i tsh w E u
thekethe	th E k> E th E
atswa	a ts> w a
polelong	p> O l E l O N
latelwang	l a t> E l w a N
gwetlhiwang	x w E tlh i w a N
anameng	a n a m E N
kgogelo	kx O x E l O
balegeng	b a l E x E N
kiletsong	k> i l E ts> O N
bopelotshetlha	b O p> E l O tsh E tlh a
mesetlha	m E s E tlh a
lebitleng	l E b i tl> E N
kaile	k> a i l E
lekima	l E k> i m a
ngwao	N w a O
sedimonthole	s E d i m O n th O l E
menomasweu	m E n O m a s w E u
berekelwa	b E r E k> E l w a
ipatlele	i p> a tl> E l E
motsereganyi	m O ts> E r E x a J i
mowafala	m O w a f a l a
majalwa	m a d0Z a l w a
fetisediwa	f E t> i s E d i w a
metlele	m E tl> E l E
dikokong	d i k> O k> O N
somaamane	s O m a m a n E
neelwang	n E E l w a N
buisiwang	b u i s i w a N
khutlisitse	kh u tl> i s i ts> E
itseele	i ts> E E l E
bogobe	b O x O b E
boloi	b O l O i
tshwaelang	tsh w a E l a N
pusomorafe	p> u s O m O r a f E
nyeletsa	J E l E ts> a
khutlang	kh u tl> a N
rasiti	r a s i t> i
tlhotlheletseng	tlh O tlh E l E ts> E N
baamogedi	b a m O x E d i
rongwa	r O N w a
adimela	a d i m E l a
ikaelelwang	i k> a E l E l w a N
tshwaetsegileng	tsh w a E ts> E x i l E N
bewang	b E w a N
itsisang	i ts> i s a N
roka	r O k> a
bokosong	b O k> O s O N
ruilwe	r u i l w E
bonagetse	b O n a x E ts> E
konyakonya	k> O J a k> O J a
borutapuo	b O r u t> a p> u O
bokeresete	b O k> E r E s E t> E
ntlhang	n tlh a N
makae	m a k> a E
lonnye	l O n J E
sebabole	s E b a b O l E
fetisiwang	f E t> i s i w a N
khwaereng	kh w a E r E N
felegetse	f E l E x E ts> E
gadime	x a d i m E
yo	j O
babalesegile	b a b a l E s E x i l E
golegeletswe	x O l E x E l E ts> w E
boemelafofane	b O E m E l a f O f a n E
ntsalaagwe	n ts> a l a x w E
tshotseng	tsh O ts> E N
kiba	k> i b a
gatetseng	x a t> E ts> E N
ditikatikong	d i t> i k> a t> i k> O N
mohumagadi	m O h u m a x a d i
thanolong	th a n O l O N
tlhokometsweng	tlh O k> O m E ts> w E N
tsitsing	ts> i ts> i N
jalwang	d0Z a l w a N
botlhapelwa	b O tlh a p> E l w a
digwete	d i x w E t> E
maleba	m a l E b a
molagare	m O l a x a r E
bahumi	b a h u m i
mararang	m a r a r a N
khobakhoba	kh O b a kh O b a
sekegilwe	s E k> E x i l w E
segatlhamelamasisi	s E x a tlh a m E l a m a s i s i
bafenyi	b a f E J i
dirolo	d i r O l O
ai	a i
makgetlho	m a kx E tlh O
seterekeng	s E t> E r E k> E N
potso	p> O ts> O
dikgolegelong	d i kx O l E x E l O N
puothuto	p> u O th u t> O
ruruga	r u r u x a
dibeso	d i b E s O
dikwaere	d i k> w a E r E
ponong	p> O n O N
suteng	s u t> E N
bolaong	b O l a O N
phatlola	ph a tl> O l a
mowafalo	m O w a f a l O
nyelediwang	J E l E d i w a N
diragatseng	d i r a x a ts> E N
lebanweng	l E b a n w E N
diduting	d i d u t> i N
dipolotwana	d i p> O l O t> w a n a
porofentsheng	p> O r O f E n tsh E N
boletsa	b O l E ts> a
sekgemetšhana	s E kx E m E tSh a n a
lenaneotema	l E n a n E O t> E m a
tshelela	tsh E l E l a
senngwang	s E n N w a N
basireletsing	b a s i r E l E ts> i N
katlegong	k> a tl> E x O N
makgaolakgang	m a kx a O l a kx a N
tshupetsokgono	tsh u p> E ts> O kx O n O
tlhalose	tlh a l O s E
feila	f E i l a
makasining	m a k> a s i n i N
dituelelo	d i t> u E l E l O
babatlisisi	b a b a tl> i s i s i
segoro	s E x O r O
gogile	x O x i l E
tlhagiso	tlh a x i s O
bathapiwa	b a th a p> i w a
ipeile	i p> E i l E
netefalediwa	n E t> E f a l E d i w a
bolodiwa	b O l O d i w a
kopanwa	k> O p> a n w a
relelela	r E l E l E l a
ditlhabano	d i tlh a b a n O
seso	s E s O
bonakonyana	b O n a k> O J a n a
botaking	b O t> a k> i N
tshwae	tsh w a E
ngotlilweng	N O tl> i l w E N
kampeng	k> a m p> E N
mabela	m a b E l a
botshepegi	b O tsh E p> E x i
nyala	J a l a
fitlhela	f i tlh E l a
dinawa	d i n a w a
moari	m O a r i
sekisediwa	s E k> i s E d i w a
bahiriwa	b a h i r i w a
duedisetswa	d u E d i s E ts> w a
betlileng	b E tl> i l E N
motlhanka	m O tlh a n k> a
patelediwe	p> a t> E l E d i w E
rekise	r E k> i s E
pu	p> u
ipatla	i p> a tl> a
gannwe	x a n n w E
bagologolo	b a x O l O x O l O
sekgwama	s E kx w a m a
lentsweng	l E n ts> w E N
tsholetsweng	tsh O l E ts> w E N
tlhagisetsa	tlh a x i s E ts> a
kgaso	kx a s O
tabogile	t> a b O x i l E
notlelwa	n O tl> E l w a
kopi	k> O p> i
ditsompelo	d i ts> O m p> E l O
bolokelwang	b O l O k> E l w a N
diipone	d i i p> O n E
kgosana	kx O s a n a
sekegelwa	s E k> E x E l w a
tatso	t> a ts> O
tikolo	t> i k> O l O
dikgwetlhong	d i kx w E tlh O N
somaamararo	s O m a m a r a r O
diphorogotlho	d i ph O r O x O tlh O
rwesiwe	r w E s i w E
ana	a n a
bonang	b O n a N
setshwantshong	s E tsh w a n tsh O N
mengwaga	m E N w a x a
adimisana	a d i m i s a n a
lopa	l O p> a
lolame	l O l a m E
sefora	s E f O r a
gobelele	x O b E l E l E
pitikologa	p> i t> i k> O l O x a
setlhangweng	s E tlh a N w E N
lono	l O n O
botsietsi	b O ts> i E ts> i
kgalemile	kx a l E m i l E
kganelwang	kx a n E l w a N
dirobotong	d i r O b O t> O N
setlaagana	s E tl> a x a n a
segologolo	s E x O l O x O l O
itumeletse	i t> u m E l E ts> E
tlamo	tl> a m O
utlwiwe	u tl> w i w E
tlosiwa	tl> O s i w a
nepa	n E p> a
pontshong	p> O n tsh O N
mogologolo	m O x O l O x O l O
tseeletsa	ts> E E l E ts> a
bagobadi	b a x O b a d i
bosiami	b O s i a m i
katisong	k> a t> i s O N
simega	s i m E x a
mafatlheng	m a f a tlh E N
lekalekanyang	l E k> a l E k> a J a N
bosenyi	b O s E J i
tshiamisetso	tsh i a m i s E ts> O
dirisiwa	d i r i s i w a
phatsimisa	ph a ts> i m i s a
fitlhwa	f i tlh w a
goditse	x O d i ts> E
sekara	s E k> a r a
dikgaisano	d i kx a i s a n O
iketle	i k> E tl> E
tlhamiweng	tlh a m i w E N
ikgobokanya	i kx O b O k> a J a
nonne	n O n n E
tswalela	ts> w a l E l a
tshelwa	tsh E l w a
lekgotleng	l E kx O tl> E N
tshepiso	tsh E p> i s O
tlhagisong	tlh a x i s O N
cox	k> O k> s
dikonopo	d i k> O n O p> O
nabo	n a b O
rakane	r a k> a n E
itshetletse	i tsh E tl> E ts> E
otla	O tl> a
mekwatla	m E k> w a tl> a
bofiwa	b O f i w a
abiwa	a b i w a
thatano	th a t> a n O
bitsa	b i ts> a
thutswe	th u ts> w E
medisa	m E d i s a
bola	b O l a
paketsweng	p> a k> E ts> w E N
monakalading	m O n a k> a l a d i N
difene	d i f E n E
tiregong	t> i r E x O N
sesupo	s E s u p> O
metseletsele	m E ts> E l E ts> E l E
boutu	b O u t> u
tlhamaletseng	tlh a m a l E ts> E N
mothamo	m O th a m O
kitsong	k> i ts> O N
balemiruing	b a l E m i r u i N
arogantse	a r O x a n ts> E
heke	h E k> E
waelese	w a E l E S E
itshomarela	i tsh O m a r E l a
rakana	r a k> a n a
ikutlwisa	i k> u tl> w i s a
boikakanyetsi	b O i k> a k> a J E ts> i
kgoneng	kx O n E N
siametseng	s i a m E ts> E N
iphorile	i ph O r i l E
jadilweng	d0Z a d i l w E N
mometso	m O m E ts> O
ditlhako	d i tlh a k> O
kotlo	k> O tl> O
sebolokelong	s E b O l O k> E l O N
kante	k> a n t> E
lesupi	l E s u p> i
kanaleng	k> a n a l E N
ammaaruri	a m m a r u r i
ithobaletse	i th O b a l E ts> E
mokgweleong	m O kx w E l E O N
reme	r E m E
thapilwe	th a p> i l w E
dingwagakgolo	d i N w a x a kx O l O
tlhabisa	tlh a b i s a
etsho	E tsh O
nyalwang	J a l w a N
borutegi	b O r u t> E x i
setegeniki	s E t> E x E n i k> i
phefong	ph E f O N
leme	l E m E
koleka	k> O l E k> a
dikgolaganyo	d i kx O l a x a J O
balelang	b a l E l a N
poelothutong	p> O E l O th u t> O N
tshosometso	tsh O s O m E ts> O
bonnye	b O n J E
ntsentse	n ts> E n ts> E
ithayang	i th a j a N
litheresi	l i th E r E s i
theileng	th E i l E N
tlhagetswe	tlh a x E ts> w E
gakgamatswa	x a kx a m a ts> w a
peneng	p> E n E N
itsale	i ts> a l E
letile	l E t> i l E
tseye	ts> E j E
tshenekegi	tsh E n E k> E x i
thibolola	th i b O l O l a
palama	p> a l a m a
tlhopiwa	tlh O p> i w a
tsekedi	ts> E k> E d i
tsholetsegile	tsh O l E ts> E x i l E
raba	r a b a
balwela	b a l w E l a
anyeng	a J E N
bopiweng	b O p> i w E N
ditsamaiso	d i ts> a m a i s O
mme	m m E
kanelo	k> a n E l O
nka	n k> a
roletsweng	r O l E ts> w E N
somepedi	s O m E p> E d i
tlhophong	tlh O ph O N
ikanyang	i k> a J a N
fenya	f E J a
tsholang	tsh O l a N
laetsweng	l a E ts> w E N
dilekanyi	d i l E k> a J i
diporoteine	d i p> O r O t> E i n E
laoletsweng	l a O l E ts> w E N
nngweng	n N w E N
phapaano	ph a p> a n O
thusanang	th u s a n a N
motshelo	m O tsh E l O
rojwa	r O d0Z w a
golegilweng	x O l E x i l w E N
tswakanyo	ts> w a k> a J O
tlhatloga	tlh a tl> O x a
lomilwe	l O m i l w E
fopholediwang	f O ph O l E d i w a N
golagantseng	x O l a x a n ts> E N
lelela	l E l E l a
senatla	s E n a tl> a
motswakong	m O ts> w a k> O N
dilaakane	d i l a k> a n E
dirisitswe	d i r i s i ts> w E
koafalo	k> O a f a l O
pegwa	p> E x w a
dumedisa	d u m E d i s a
ikantseng	i k> a n ts> E N
nepagalo	n E p> a x a l O
konteraka	k> O n t> E r a k> a
ruta	r u t> a
metsesetoropo	m E ts> E s E t> O r O p> O
mothalo	m O th a l O
kaiwa	k> a i w a
tlelaseng	tl> E l a s E N
khampaseng	kh a m p> a s E N
neelo	n E E l O
tswelelepele	ts> w E l E l E p> E l E
tshimong	tsh i m O N
ikgatholosiwa	i kx a th O l O s i w a
tlaleletseng	tl> a l E l E ts> E N
tlhalosa	tlh a l O s a
tholotiro	th O l O t> i r O
nkoba	n k> O b a
rata	r a t> a
tlhokegang	tlh O k> E x a N
selekanyong	s E l E k> a J O N
mantšhwa	m a n tSh w a
sesele	s E s E l E
basupi	b a s u p> i
baalogi	b a l O x i
tshwaiwa	tsh w a i w a
tlamego	tl> a m E x O
dirisitseng	d i r i s i ts> E N
dikakana	d i k> a k> a n a
marakanamantsi	m a r a k> a n a m a n ts> i
kopanelo	k> O p> a n E l O
tshwaetso	tsh w a E ts> O
fela	f E l a
dika	d i k> a
diragaditswe	d i r a x a d i ts> w E
badimong	b a d i m O N
mekgele	m E kx E l E
akantse	a k> a n ts> E
letsatsa	l E ts> a ts> a
tlhopa	tlh O p> a
dithusi	d i th u s i
peba	p> E b a
laisitseng	l a i s i ts> E N
motlatsamogokgo	m O tl> a ts> a m O x O kx O
iponatsa	i p> O n a ts> a
ikwadisang	i k> w a d i s a N
balwa	b a l w a
motlhologadi	m O tlh O l O x a d i
ratshikana	r a tsh i k> a n a
isago	i s a x O
agelang	a x E l a N
tobekane	t> O b E k> a n E
tswelelopele	ts> w E l E l O p> E l E
fudugile	f u d u x i l E
manong	m a n O N
thaelo	th a E l O
pilediwa	p> i l E d i w a
raelesega	r a E l E S E x a
tlotleng	tl> O tl> E N
thutafatshe	th u t> a f a tsh E
thepe	th E p> E
basenatoro	b a s E n a t> O r O
nkile	n k> i l E
ngangela	N a N x E l a
tlwaetse	tl> w a E ts> E
belefo	b E l E f O
ipusulosetsa	i p> u s u l O s E ts> a
lorisitswe	l O r i s i ts> w E
itumela	i t> u m E l a
tiso	t> i s O
beke	b E k> E
disitse	d i s i ts> E
teraka	t> E r a k> a
motlameding	m O tl> a m E d i N
dipakeng	d i p> a k> E N
feletsa	f E l E ts> a
natefelwa	n a t> E f E l w a
tshwaiwe	tsh w a i w E
senokwane	s E n O k> w a n E
maduo	m a d u O
leratla	l E r a tl> a
kirimi	k> i r i m i
ipolaya	i p> O l a j a
seporo	s E p> O r O
laesenseng	l a E s E n s E N
menaganya	m E n a x a J a
setopo	s E t> O p> O
thobego	th O b E x O
tlhophiwang	tlh O ph i w a N
mothapiwa	m O th a p> i w a
dikala	d i k> a l a
tshoutiso	tsh O u t> i s O
mothelesing	m O th E l E s i N
booki	b O O k> i
rutela	r u t> E l a
tsweetswee	ts> w E E ts> w E E
ona	O n a
itshokele	i tsh O k> E l E
tsogo	ts> O x O
makasini	m a k> a s i n i
matshwenyegonyana	m a tsh w E J E x O J a n a
lerothodi	l E r O th O d i
patlomaikutlo	p> a tl> O m a i k> u tl> O
fetile	f E t> i l E
dikweletla	d i k> w E l E tl> a
direlwa	d i r E l w a
dikabong	d i k> a b O N
thini	th i n i
lapa	l a p> a
moswagadi	m O s w a x a d i
katlholo	k> a tlh O l O
ditlogolo	d i tl> O x O l O
batsamaising	b a ts> a m a i s i N
modirisong	m O d i r i s O N
tshwaretsweng	tsh w a r E ts> w E N
