tsholetse	tsh O l E ts> E
tlhotlhorega	tlh O tlh O r E x a
tlhako	tlh a k> O
robilweng	r O b i l w E N
phufulelo	ph u f u l E l O
posetsa	p> O s E ts> a
katso	k> a ts> O
tswelopeleng	ts> w E l O p> E l E N
rangwaneagwe	r a N w a n E a x w E
itshega	i tsh E x a
ketekong	k> E t> E k> O N
kosene	k> O s E n E
bophirima	b O ph i r i m a
agiwe	a x i w E
dikgetho	d i kx E th O
makgotla	m a kx O tl> a
metlhala	m E tlh a l a
baloto	b a l O t> O
kgotlhelelang	kx O tlh E l E l a N
phufudi	ph u f u d i
fologelang	f O l O x E l a N
phatlhatirong	ph a tlh a t> i r O N
laole	l a O l E
nkgaisa	n kx a i s a
segiwa	s E x i w a
boferefere	b O f E r E f E r E
tirisong	t> i r i s O N
palangwa	p> a l a N w a
malokololong	m a l O k> O l O l O N
intsha	i n tsh a
nyadiwa	J a d i w a
tlhaotswe	tlh a O ts> w E
boikitsiso	b O i k> i ts> i s O
tlhagafaditswe	tlh a x a f a d i ts> w E
pompong	p> O m p> O N
ntweng	n t> w E N
tswelwa	ts> w E l w a
losi	l O s i
barekisi	b a r E k> i s i
mmalo	m m a l O
boutelwe	b O u t> E l w E
dilwaneng	d i l w a n E N
dikgotlapeomolao	d i kx O tl> a p> E O m O l a O
khefi	kh E f i
dikoporasi	d i k> O p> O r a s i
dikhalentara	d i kh a l E n t> a r a
tlotlilwe	tl> O tl> i l w E
sešwa	s E S w a
aroganang	a r O x a n a N
dibukantswe	d i b u k> a n ts> w E
moreetsi	m O r E E ts> i
bodilo	b O d i l O
latlhegelwa	l a tlh E x E l w a
phutha	ph u th a
laiwa	l a i w a
katolosiwa	k> a t> O l O s i w a
disakatuku	d i s a k> a t> u k> u
tlotlile	tl> O tl> i l E
sosobanye	s O s O b a J E
tlhageletse	tlh a x E l E ts> E
repetlaneng	r E p> E tl> a n E N
sefela	s E f E l a
kgomo	kx O m O
tlhokofetse	tlh O k> O f E ts> E
dipina	d i p> i n a
kwalang	k> w a l a N
mokaedimogolo	m O k> a E d i m O x O l O
matsatsinyana	m a ts> a ts> i J a n a
ditorong	d i t> O r O N
pele	p> E l E
fala	f a l a
tshwentswe	tsh w E n ts> w E
itsholelo	i tsh O l E l O
maitseanape	m a i ts> E a n a p> E
mogami	m O x a m i
rarabolola	r a r a b O l O l a
boelang	b O E l a N
difofane	d i f O f a n E
kopetsweng	k> O p> E ts> w E N
tlotswe	tl> O ts> w E
motlhatlheledi	m O tlh a tlh E l E d i
tsidifaditsweng	ts> i d i f a d i ts> w E N
sone	s O n E
tlhotlhora	tlh O tlh O r a
kakantsho	k> a k> a n tsh O
humanega	h u m a n E x a
fensetere	f E n s E t> E r E
tebelane	t> E b E l a n E
kutlwano	k> u tl> w a n O
seeng	s E E N
tlositse	tl> O s i ts> E
bonnyane	b O n J a n E
netefatse	n E t> E f a ts> E
tlhotlhomisitswe	tlh O tlh O m i s i ts> w E
bonnyeng	b O n J E N
dinetefaletso	d i n E t> E f a l E ts> O
dimmaene	d i m m a E n E
ditshego	d i tsh E x O
boikanyegi	b O i k> a J E x i
kganetsano	kx a n E ts> a n O
gotlholetseng	x O tlh O l E ts> E N
tlhokomedisa	tlh O k> O m E d i s a
sedifala	s E d i f a l a
tseela	ts> E E l a
semathana	s E m a th a n a
diemo	d i E m O
onala	O n a l a
gamololwa	x a m O l O l w a
rakgadiagwe	r a kx a d i a x w E
tilwe	t> i l w E
gakadiwang	x a k> a d i w a N
dikgetsi	d i kx E ts> i
tlhabologela	tlh a b O l O x E l a
tlhaolegang	tlh a O l E x a N
maragong	m a r a x O N
lešwa	l E S w a
kgatlhegelang	kx a tlh E x E l a N
tlhobogilwe	tlh O b O x i l w E
bolemirui	b O l E m i r u i
jalega	d0Z a l E x a
ipateletsa	i p> a t> E l E ts> a
thopile	th O p> i l E
nkgong	n kx O N
pelotelele	p> E l O t> E l E l E
lopiwa	l O p> i w a
emelang	E m E l a N
bakegang	b a k> E x a N
ikatametsa	i k> a t> a m E ts> a
lebogelang	l E b O x E l a N
gasagasiwang	x a s a x a s i w a N
nneileng	n n E i l E N
paseporoto	p> a s E p> O r O t> O
mainamatswa	m a i n a m a ts> w a
metlhatlagano	m E tlh a tl> a x a n O
somarelegile	s O m a r E l E x i l E
omileng	O m i l E N
dithitokgang	d i th i t> O kx a N
botlalo	b O tl> a l O
tlhokegeng	tlh O k> E x E N
sekasekile	s E k> a s E k> i l E
tsosolosiwa	ts> O s O l O s i w a
digwere	d i x w E r E
diyunione	d i j u n i O n E
tletsetletse	tl> E ts> E tl> E ts> E
lelapa	l E l a p> a
makgoeng	m a kx O E N
kgobelelo	kx O b E l E l O
latlhegelwe	l a tlh E x E l w E
tlhophelwa	tlh O ph E l w a
lwelwa	l w E l w a
sweditswe	s w E d i ts> w E
kgamolo	kx a m O l O
sireletsa	s i r E l E ts> a
tshwaraganyeng	tsh w a r a x a J E N
goeleditse	x O E l E d i ts> E
fitlhegileng	f i tlh E x i l E N
meriti	m E r i t> i
phekola	ph E k> O l a
ditlhophelo	d i tlh O ph E l O
amogelwe	a m O x E l w E
motsofeng	m O ts> O f E N
tshwantsho	tsh w a n tsh O
lebelwa	l E b E l w a
fiwang	f i w a N
gatsediwang	x a ts> E d i w a N
atolosang	a t> O l O s a N
tshenyegong	tsh E J E x O N
tliseditse	tl> i s E d i ts> E
tlhaloganya	tlh a l O x a J a
ditirong	d i t> i r O N
tlhomong	tlh O m O N
mantsinyana	m a n ts> i J a n a
tlhomamiso	tlh O m a m i s O
lole	l O l E
mmuisano	m m u i s a n O
dikgatlegong	d i kx a tl> E x O N
boesi	b O E s i
tenteng	t> E n t> E N
gomotswa	x O m O ts> w a
mathamo	m a th a m O
thulaganyetsong	th u l a x a J E ts> O N
amoganwe	a m O x a n w E
lemosiwang	l E m O s i w a N
boipiletso	b O i p> i l E ts> O
sikara	s i k> a r a
kgakajana	kx a k> a d0Z a n a
kete	k> E t> E
diphetogo	d i ph E t> O x O
dikerafiki	d i k> E r a f i k> i
makgasa	m a kx a s a
roto	r O t> O
dinaga	d i n a x a
gakgamalela	x a kx a m a l E l a
rekegela	r E k> E x E l a
bosimaneng	b O s i m a n E N
itlhaba	i tlh a b a
thobo	th O b O
atlenegisiwa	a tl> E n E x i s i w a
anamisiwang	a n a m i s i w a N
ntsimane	n ts> i m a n E
sekgono	s E kx O n O
ikokeletsa	i k> O k> E l E ts> a
kgotlelo	kx O tl> E l O
morogo	m O r O x O
marekisetso	m a r E k> i s E ts> O
fetiseditswe	f E t> i s E d i ts> w E
letshwafo	l E tsh w a f O
meonong	m E O n O N
gakgamatsa	x a kx a m a ts> a
tsebeng	ts> E b E N
ketekeng	k> E t> E k> E N
dikema	d i k> E m a
ageletsweng	a x E l E ts> w E N
ditshekatshekong	d i tsh E k> a tsh E k> O N
dumelesegang	d u m E l E s E x a N
sentseng	s E n ts> E N
tshomarelong	tsh O m a r E l O N
nagana	n a x a n a
buela	b u E l a
mathapama	m a th a p> a m a
boutang	b O u t> a N
bobogelong	b O b O x E l O N
segorong	s E x O r O N
engwe	E N w E
diphatla	d i ph a tl> a
faela	f a E l a
lomao	l O m a O
buledise	b u l E d i s E
maitekong	m a i t> E k> O N
buseditseng	b u s E d i ts> E N
kgarakgatsha	kx a r a kx a tsh a
ipeetseng	i p> E E ts> E N
ditshwanelong	d i tsh w a n E l O N
motsading	m O ts> a d i N
kgoba	kx O b a
dipeipe	d i p> E i p> E
feteleditsweng	f E t> E l E d i ts> w E N
bonaneng	b O n a n E N
babaletse	b a b a l E ts> E
dipampitshana	d i p> a m p> i tsh a n a
ikatlhola	i k> a tlh O l a
oketse	O k> E ts> E
ngwega	N w E x a
atlholelwe	a tlh O l E l w E
itapolosa	i t> a p> O l O s a
gagamala	x a x a m a l a
maitshwarelo	m a i tsh w a r E l O
amoganweng	a m O x a n w E N
phopholetsa	ph O ph O l E ts> a
tsereganyong	ts> E r E x a J O N
lebelelwang	l E b E l E l w a N
maabaneng	m a b a n E N
tlhatlhamolola	tlh a tlh a m O l O l a
makgolokgolo	m a kx O l O kx O l O
fudugele	f u d u x E l E
ntekaneng	n t> E k> a n E N
tlolomolaong	tl> O l O m O l a O N
tlhotlhololo	tlh O tlh O l O l O
tlogetswe	tl> O x E ts> w E
dikamong	d i k> a m O N
dipotsane	d i p> O ts> a n E
ditwatsi	d i t> w a ts> i
nakedi	n a k> E d i
matute	m a t> u t> E
bakatisiwa	b a k> a t> i s i w a
babotlana	b a b O tl> a n a
motseng	m O ts> E N
ene	E n E
marago	m a r a x O
arabiwa	a r a b i w a
tlhometsweng	tlh O m E ts> w E N
lethuuthuu	l E th u u th u u
tlhala	tlh a l a
dithekong	d i th E k> O N
kelong	k> E l O N
pheta	ph E t> a
tibola	t> i b O l a
tshabang	tsh a b a N
lemiwang	l E m i w a N
nokong	n O k> O N
nna	n n a
saenelwa	s a E n E l w a
sepetlele	s E p> E tl> E l E
setekeniki	s E t> E k> E n i k> i
bitswang	b i ts> w a N
feleletsa	f E l E l E ts> a
lomeleditswe	l O m E l E d i ts> w E
kholetšheng	kh O l E tSh E N
mathuding	m a th u d i N
tlhaeletsanong	tlh a E l E ts> a n O N
thatathata	th a t> a th a t> a
rulagangwa	r u l a x a N w a
rua	r u a
phaa	ph a a
bothong	b O th O N
ditekeletso	d i t> E k> E l E ts> O
supiwa	s u p> i w a
ipusolosetso	i p> u s O l O s E ts> O
malebela	m a l E b E l a
kgaitsadia	kx a i ts> a d i a
tlhoafalang	tlh O a f a l a N
eteleditse	E t> E l E d i ts> E
metlapa	m E tl> a p> a
balekanyetsi	b a l E k> a J E ts> i
sokamisang	s O k> a m i s a N
lekeng	l E k> E N
atolosiwang	a t> O l O s i w a N
bolola	b O l O l a
bonto	b O n t> O
manno	m a n n O
neelang	n E E l a N
baamogeding	b a m O x E d i N
tumelanong	t> u m E l a n O N
lekala	l E k> a l a
tetesela	t> E t> E s E l a
nthuse	n th u s E
lenaanefoko	l E n a n E f O k> O
ntshana	n tsh a n a
sutiseditsweng	s u t> i s E d i ts> w E N
phetiso	ph E t> i s O
bokhutlo	b O kh u tl> O
buisaneng	b u i s a n E N
utlwale	u tl> w a l E
leditseng	l E d i ts> E N
mpateletsa	m p> a t> E l E ts> a
kabakanye	k> a b a k> a J E
obamela	O b a m E l a
bobi	b O b i
tlhakanelo	tlh a k> a n E l O
moreki	m O r E k> i
magosi	m a x O s i
tirokgolo	t> i r O kx O l O
moagisani	m O a x i s a n i
ntsifalo	n ts> i f a l O
bokone	b O k> O n E
moratiwa	m O r a t> i w a
beibeleng	b E i b E l E N
tlhagiseditsweng	tlh a x i s E d i ts> w E N
ima	i m a
loruong	l O r u O N
mefuteng	m E f u t> E N
tlhometseng	tlh O m E ts> E N
ntlhaloganya	n tlh a l O x a J a
kgalalelo	kx a l a l E l O
kgaitsadiake	kx a i ts> a d i a k> E
tshwaraganetswe	tsh w a r a x a n E ts> w E
bolaya	b O l a j a
khurumele	kh u r u m E l E
lekgetlo	l E kx E tl> O
gasagasang	x a s a x a s a N
kgotsofaditse	kx O ts> O f a d i ts> E
etleediwang	E tl> E E d i w a N
ditshweu	d i tsh w E u
rerilwe	r E r i l w E
makubu	m a k> u b u
boithutelo	b O i th u t> E l O
mmuso	m m u s O
tlhafuniwang	tlh a f u n i w a N
nnisega	n n i s E x a
letsang	l E ts> a N
borona	b O r O n a
dijana	d i d0Z a n a
peo	p> E O
raraana	r a r a n a
buiseng	b u i s E N
bogorogelong	b O x O r O x E l O N
motswantle	m O ts> w a n tl> E
tlisitseng	tl> i s i ts> E N
magologolo	m a x O l O x O l O
tlhalosiwe	tlh a l O s i w E
lobakanyana	l O b a k> a J a n a
itlhatlhoba	i tlh a tlh O b a
dikamoreng	d i k> a m O r E N
kgabagantse	kx a b a x a n ts> E
itlhagisa	i tlh a x i s a
batlwa	b a tl> w a
salwa	s a l w a
noga	n O x a
sekai	s E k> a i
setlela	s E tl> E l a
mpa	m p> a
baakanyetsang	b a k> a J E ts> a N
boenjenere	b O E n d0Z E n E r E
fetogeng	f E t> O x E N
makoko	m a k> O k> O
baokamedi	b a O k> a m E d i
gatake	x a t> a k> E
tshwaraganetsweng	tsh w a r a x a n E ts> w E N
tlhatlhama	tlh a tlh a m a
tlhakatlhakantswe	tlh a k> a tlh a k> a n ts> w E
tlhaloseditsweng	tlh a l O s E d i ts> w E N
lebisiwa	l E b i s i w a
nathela	n a th E l a
ithusa	i th u s a
dinamanyane	d i n a m a J a n E
moadingwa	m O a d i N w a
kgotlapeomolaong	kx O tl> a p> E O m O l a O N
matshwenyegong	m a tsh w E J E x O N
kwalweng	k> w a l w E N
tsweletso	ts> w E l E ts> O
kokoro	k> O k> O r O
lemositswe	l E m O s i ts> w E
melaetsa	m E l a E ts> a
gobeleleng	x O b E l E l E N
maanong	m a n O N
rwesiwang	r w E s i w a N
dikopo	d i k> O p> O
mookana	m O O k> a n a
bophiri	b O ph i r i
melang	m E l a N
latlhela	l a tlh E l a
tshokane	tsh O k> a n E
ikepela	i k> E p> E l a
bosetšhabeng	b O s E tSh a b E N
tlhofofatseng	tlh O f O f a ts> E N
tlhokafaleng	tlh O k> a f a l E N
saletswe	s a l E ts> w E
mafora	m a f O r a
moanelwamogolo	m O a n E l w a m O x O l O
etswe	E ts> w E
segompieno	s E x O m p> i E n O
ntloboithusetso	n tl> O b O i th u s E ts> O
tlhagile	tlh a x i l E
fitlhe	f i tlh E
tlhagelelang	tlh a x E l E l a N
fotlhwa	f O tlh w a
ngweding	N w E d i N
bagabona	b a x a b O n a
fopholetsa	f O ph O l E ts> a
siamisitse	s i a m i s i ts> E
morwao	m O r w a O
boelediwang	b O E l E d i w a N
lentswetshipi	l E n ts> w E tsh i p> i
morongwa	m O r O N w a
folaga	f O l a x a
dibasari	d i b a s a r i
logato	l O x a t> O
huhumela	h u h u m E l a
tokafetseng	t> O k> a f E ts> E N
utswiwa	u ts> w i w a
diseleng	d i s E l E N
dithaelo	d i th a E l O
ntuela	n t> u E l a
kgwathisa	kx w a th i s a
amogela	a m O x E l a
thadile	th a d i l E
tatlho	t> a tlh O
rulaganyeditsweng	r u l a x a J E d i ts> w E N
bopodisi	b O p> O d i s i
tshikintsweng	tsh i k> i n ts> w E N
letlwa	l E tl> w a
tshusumetso	tsh u s u m E ts> O
ikoketsa	i k> O k> E ts> a
sekgoeng	s E kx O E N
tswetsweng	ts> w E ts> w E N
ama	a m a
tlhomelong	tlh O m E l O N
sesheng	s E s E N
dipolaseng	d i p> O l a s E N
aperweng	a p> E r w E N
dirisiwe	d i r i s i w E
dišereng	d i S E r E N
lebowa	l E b O w a
pateletsa	p> a t> E l E ts> a
kgang	kx a N
metšhini	m E tSh i n i
falola	f a l O l a
fediseng	f E d i s E N
nkabo	n k> a b O
bokima	b O k> i m a
nyorwa	J O r w a
lefetlho	l E f E tlh O
netefadiwa	n E t> E f a d i w a
bokile	b O k> i l E
kgoboko	kx O b O k> O
nkise	n k> i s E
digokedi	d i x O k> E d i
iwa	i w a
ditlhatlhobong	d i tlh a tlh O b O N
tsa	ts> a
phesente	ph E s E n t> E
tennyana	t> E n J a n a
tlwaela	tl> w a E l a
letlhakanoka	l E tlh a k> a n O k> a
lekalekanya	l E k> a l E k> a J a
ikaya	i k> a j a
motsamaong	m O ts> a m a O N
refosana	r E f O s a n a
senyang	s E J a N
ganelwang	x a n E l w a N
bongapa	b O N a p> a
kgama	kx a m a
sitisang	s i t> i s a N
dikgomong	d i kx O m O N
pharuma	ph a r u m a
konetsweng	k> O n E ts> w E N
tlayang	tl> a j a N
kwalelano	k> w a l E l a n O
sesiraphefo	s E s i r a ph E f O
melemong	m E l E m O N
rutweng	r u t> w E N
kamego	k> a m E x O
rulagangwang	r u l a x a N w a N
mpana	m p> a n a
gontlentle	x O n tl> E n tl> E
matheka	m a th E k> a
pateletso	p> a t> E l E ts> O
kologanya	k> O l O x a J a
terama	t> E r a m a
thapolo	th a p> O l O
bosengbofitlha	b O s E N b O f i tlh a
lemogwa	l E m O x w a
mpaola	m p> a O l a
ipueletse	i p> u E l E ts> E
golaganang	x O l a x a n a N
bopalamelo	b O p> a l a m E l O
fodisiwa	f O d i s i w a
ikwatlhaya	i k> w a tlh a j a
bogisiwa	b O x i s i w a
dikgoro	d i kx O r O
moapari	m O a p> a r i
sekopa	s E k> O p> a
nonotsha	n O n O tsh a
thuba	th u b a
peong	p> E O N
kgwisiwang	kx w i s i w a N
tsweletsapele	ts> w E l E ts> a p> E l E
dikima	d i k> i m a
jenaleng	d0Z E n a l E N
marukgwe	m a r u kx w E
lonyatso	l O J a ts> O
jeleng	d0Z E l E N
rutla	r u tl> a
akanyeditseng	a k> a J E d i ts> E N
rothile	r O th i l E
phaposiborutelo	ph a p> O s i b O r u t> E l O
apesa	a p> E s a
godiseditse	x O d i s E d i ts> E
ntomeletsa	n t> O m E l E ts> a
polata	p> O l a t> a
tshwaiso	tsh w a i s O
bomosola	b O m O s O l a
boitshwarelo	b O i tsh w a r E l O
tlholego	tlh O l E x O
sekolosegolong	s E k> O l O s E x O l O N
bonolo	b O n O l O
maidi	m a i d i
mekhukhu	m E kh u kh u
bontsintsi	b O n ts> i n ts> i
didiba	d i d i b a
ikemela	i k> E m E l a
kana	k> a n a
tlhobogela	tlh O b O x E l a
ikarabele	i k> a r a b E l E
senya	s E J a
boiphemelo	b O i ph E m E l O
bonnete	b O n n E t> E
rakalala	r a k> a l a l a
bophasalatsi	b O ph a s a l a ts> i
phutholola	ph u th O l O l a
moakanyetso	m O a k> a J E ts> O
ikgethela	i kx E th E l a
hularetseng	h u l a r E ts> E N
tlisiwang	tl> i s i w a N
gobala	x O b a l a
molemi	m O l E m i
phepafaditswe	ph E p> a f a d i ts> w E
porofaele	p> O r O f a E l E
totilweng	t> O t> i l w E N
kgatshe	kx a tsh E
tafole	t> a f O l E
dikuranteng	d i k> u r a n t> E N
tshoganyetso	tsh O x a J E ts> O
kgarametsa	kx a r a m E ts> a
bokwadisetso	b O k> w a d i s E ts> O
forong	f O r O N
masisi	m a s i s i
kopanyeng	k> O p> a J E N
ditiragatsong	d i t> i r a x a ts> O N
simologa	s i m O l O x a
sirang	s i r a N
hemelwa	h E m E l w a
kgakgauthe	kx a kx a u th E
tlamele	tl> a m E l E
diile	d i i l E
polelwanakutu	p> O l E l w a n a k> u t> u
kgokaganyo	kx O k> a x a J O
diposong	d i p> O s O N
quilt	k> w i l t>
nosetso	n O s E ts> O
khutsafalo	kh u ts> a f a l O
dikerekeng	d i k> E r E k> E N
tlhaselo	tlh a s E l O
bobolokelong	b O b O l O k> E l O N
etelelwa	E t> E l E l w a
ipateletse	i p> a t> E l E ts> E
mathaithai	m a th a i th a i
gogolang	x O x O l a N
letlojaneng	l E tl> O d0Z a n E N
dithulaganyetso	d i th u l a x a J E ts> O
kopokgolo	k> O p> O kx O l O
fetogafetoga	f E t> O x a f E t> O x a
arogangwa	a r O x a N w a
selekanyetsi	s E l E k> a J E ts> i
rekeng	r E k> E N
boapeelo	b O a p> E E l O
ranotsweng	r a n O ts> w E N
garumela	x a r u m E l a
bosweng	b O s w E N
logiwa	l O x i w a
gonnye	x O n J E
romeletswe	r O m E l E ts> w E
emeletseng	E m E l E ts> E N
sena	s E n a
metale	m E t> a l E
ditlhakaina	d i tlh a k> a i n a
hoko	h O k> O
itlhoboge	i tlh O b O x E
sepodisi	s E p> O d i s i
tlotlomatsa	tl> O tl> O m a ts> a
majang	m a d0Z a N
lebeletse	l E b E l E ts> E
tlwaetswa	tl> w a E ts> w a
tshwaye	tsh w a j E
sebolai	s E b O l a i
atlhame	a tlh a m E
ikutlwe	i k> u tl> w E
ketsaetsego	k> E ts> a E ts> E x O
berekela	b E r E k> E l a
entisa	E n t> i s a
bophepa	b O ph E p> a
seakatemi	s E a k> a t> E m i
rwalang	r w a l a N
reilweng	r E i l w E N
dipoleite	d i p> O l E i t> E
motlatla	m O tl> a tl> a
nnyatsa	n J a ts> a
fentseng	f E n ts> E N
moleng	m O l E N
tshikinngwang	tsh i k> i n N w a N
latelanye	l a t> E l a J E
salela	s a l E l a
sira	s i r a
mogala	m O x a l a
ipolela	i p> O l E l a
seša	s E S a
balekeletsi	b a l E k> E l E ts> i
pinyelediwa	p> i J E l E d i w a
biditse	b i d i ts> E
diega	d i E x a
letla	l E tl> a
tlhamalalang	tlh a m a l a l a N
khutlisa	kh u tl> i s a
thotloetso	th O tl> O E ts> O
fokoditswe	f O k> O d i ts> w E
latela	l a t> E l a
lefatshe	l E f a tsh E
mmalwanyana	m m a l w a J a n a
engwa	E N w a
tiisediwa	t> i i s E d i w a
lebelelwe	l E b E l E l w E
boutetseng	b O u t> E ts> E N
itumelelana	i t> u m E l E l a n a
tekanong	t> E k> a n O N
minolosetsa	m i n O l O s E ts> a
baagelani	b a x E l a n i
dithole	d i th O l E
serobing	s E r O b i N
kgwatata	kx w a t> a t> a
tumedi	t> u m E d i
kaetso	k> a E ts> O
kgweding	kx w E d i N
theiwe	th E i w E
setimela	s E t> i m E l a
malwetseng	m a l w E ts> E N
dinoga	d i n O x a
tshwareng	tsh w a r E N
boranti	b O r a n t> i
matlapeng	m a tl> a p> E N
thaelong	th a E l O N
ganwa	x a n w a
motogo	m O t> O x O
dipalangwang	d i p> a l a N w a N
dirilwe	d i r i l w E
maemelo	m a E m E l O
potlana	p> O tl> a n a
bahumanegi	b a h u m a n E x i
majwe	m a d0Z w E
utlwanang	u tl> w a n a N
tumalanong	t> u m a l a n O N
khabone	kh a b O n E
resepi	r E s E p> i
kwalwe	k> w a l w E
bonota	b O n O t> a
pata	p> a t> a
disenke	d i s E n k> E
tshelelang	tsh E l E l a N
masalela	m a s a l E l a
diruiweng	d i r u i w E N
fosagetse	f O s a x E ts> E
maeto	m a E t> O
itshietse	i tsh i E ts> E
selonyana	s E l O J a n a
boloditswe	b O l O d i ts> w E
banake	b a n a k> E
alafang	a l a f a N
morara	m O r a r a
sekale	s E k> a l E
dinoko	d i n O k> O
nwaa	n w a
setlhokwa	s E tlh O k> w a
idibatsa	i d i b a ts> a
moila	m O i l a
ditoropokgolo	d i t> O r O p> O kx O l O
sebofo	s E b O f O
ngwagang	N w a x a N
besa	b E s a
phoko	ph O k> O
leuba	l E u b a
pono	p> O n O
rulaganya	r u l a x a J a
kgaoganyeng	kx a O x a J E N
lomaganeng	l O m a x a n E N
matsobane	m a ts> O b a n E
tsurama	ts> u r a m a
mesele	m E s E l E
taolelong	t> a O l E l O N
ipopileng	i p> O p> i l E N
fatlhoga	f a tlh O x a
dirolola	d i r O l O l a
ditlhatlhobo	d i tlh a tlh O b O
nyalelane	J a l E l a n E
tletse	tl> E ts> E
totobala	t> O t> O b a l a
kwadise	k> w a d i s E
buisa	b u i s a
dinakong	d i n a k> O N
eleletse	E l E l E ts> E
temoso	t> E m O s O
robalang	r O b a l a N
tiiseditsweng	t> i i s E d i ts> w E N
utswe	u ts> w E
dithebe	d i th E b E
kwalwang	k> w a l w a N
boitlamo	b O i tl> a m O
senotlolo	s E n O tl> O l O
jele	d0Z E l E
thubilweng	th u b i l w E N
reise	r E i s E
dikgogakgogano	d i kx O x a kx O x a n O
dikonteraka	d i k> O n t> E r a k> a
memorantamo	m E m O r a n t> a m O
tlalelediwa	tl> a l E l E d i w a
utlwaleng	u tl> w a l E N
khonkerese	kh O n k> E r E s E
tshwarong	tsh w a r O N
kgwisang	kx w i s a N
thatafalo	th a t> a f a l O
mennye	m E n J E
ditlwaelo	d i tl> w a E l O
makgati	m a kx a t> i
mosading	m O s a d i N
meono	m E O n O
ditšhipisi	d i tSh i p> i s i
gwantisiwa	x w a n t> i s i w a
kgogo	kx O x O
tharong	th a r O N
ikgethelwang	i kx E th E l w a N
boitlhophelong	b O i tlh O ph E l O N
ditoropokgolong	d i t> O r O p> O kx O l O N
dimentlele	d i m E n tl> E l E
methalethale	m E th a l E th a l E
sebatanyana	s E b a t> a J a n a
itshwenyetsang	i tsh w E J E ts> a N
aroganya	a r O x a J a
konotelelwa	k> O n O t> E l E l w a
matshosetsi	m a tsh O s E ts> i
legano	l E x a n O
borukhutlhi	b O r u kh u tlh i
agetswe	a x E ts> w E
mediriso	m E d i r i s O
ditheiboleng	d i th E i b O l E N
latedisiwa	l a t> E d i s i w a
sekapuo	s E k> a p> u O
mekwalo	m E k> w a l O
tlhaloso	tlh a l O s O
lepalepanya	l E p> a l E p> a J a
balega	b a l E x a
lesego	l E s E x O
terene	t> E r E n E
mohubu	m O h u b u
diphirimisi	d i ph i r i m i s i
buiwe	b u i w E
moalong	m O a l O N
sisa	s i s a
tlhophile	tlh O ph i l E
digoro	d i x O r O
belegwe	b E l E x w E
ditlontlokwane	d i tl> O n tl> O k> w a n E
tlhatlhobotsweledi	tlh a tlh O b O ts> w E l E d i
kerekeng	k> E r E k> E N
ntira	n t> i r a
ditshoswane	d i tsh O s w a n E
boithusetso	b O i th u s E ts> O
kgatlhisang	kx a tlh i s a N
dithoko	d i th O k> O
kgwageditsweng	kx w a x E d i ts> w E N
akanngwa	a k> a n N w a
intshwarele	i n tsh w a r E l E
thusang	th u s a N
pontsheng	p> O n tsh E N
bodisa	b O d i s a
mekamekana	m E k> a m E k> a n a
tshepa	tsh E p> a
mokwalong	m O k> w a l O N
sekwa	s E k> w a
maitisong	m a i t> i s O N
lenga	l E N a
tlasetlase	tl> a s E tl> a s E
kgotso	kx O ts> O
begegang	b E x E x a N
mananeo	m a n a n E O
meraferafe	m E r a f E r a f E
agwang	a x w a N
kasete	k> a s E t> E
dibukana	d i b u k> a n a
emetse	E m E ts> E
tshitsinya	tsh i ts> i J a
bagokolodi	b a x O k> O l O d i
ditekeletsong	d i t> E k> E l E ts> O N
kgaphela	kx a ph E l a
opile	O p> i l E
itlhaole	i tlh a O l E
kgotetso	kx O t> E ts> O
ngongoregelang	N O N O r E x E l a N
thuthusa	th u th u s a
dumeleng	d u m E l E N
matlholaadibona	m a tlh O l a d i b O n a
tloliwa	tl> O l i w a
moeteledipele	m O E t> E l E d i p> E l E
botshwaro	b O tsh w a r O
patelelo	p> a t> E l E l O
thapa	th a p> a
leanong	l E a n O N
etelelang	E t> E l E l a N
swetseng	s w E ts> E N
ntshiweng	n tsh i w E N
manyalong	m a J a l O N
diragalela	d i r a x a l E l a
sukiri	s u k> i r i
pakang	p> a k> a N
methapong	m E th a p> O N
koafatse	k> O a f a ts> E
bofitlha	b O f i tlh a
ganetsa	x a n E ts> a
rogana	r O x a n a
pitseng	p> i ts> E N
menogang	m E n O x a N
tlhomilwe	tlh O m i l w E
bathusi	b a th u s i
mohiri	m O h i r i
nkeme	n k> E m E
masakaneng	m a s a k> a n E N
fitlhetseng	f i tlh E ts> E N
dielong	d i E l O N
tshingwana	tsh i N w a n a
romelwa	r O m E l w a
kgotlhelela	kx O tlh E l E l a
motsing	m O ts> i N
setlhako	s E tlh a k> O
bobueledi	b O b u E l E d i
maitlhomong	m a i tlh O m O N
loago	l O a x O
maikemisetsong	m a i k> E m i s E ts> O N
makgotlatoropo	m a kx O tl> a t> O r O p> O
salang	s a l a N
sebela	s E b E l a
malapa	m a l a p> a
hoteleng	h O t> E l E N
rudisa	r u d i s a
ithutiwa	i th u t> i w a
boletse	b O l E ts> E
matiriki	m a t> i r i k> i
tshwengwa	tsh w E N w a
boronse	b O r O n s E
mongongoregi	m O N O N O r E x i
peterole	p> E t> E r O l E
fenitšhara	f E n i tSh a r a
bodiwang	b O d i w a N
ithata	i th a t> a
foufaditswe	f O u f a d i ts> w E
swediwa	s w E d i w a
mebarakeng	m E b a r a k> E N
emelanang	E m E l a n a N
kagiso	k> a x i s O
senyegileng	s E J E x i l E N
phologo	ph O l O x O
moolwana	m O O l w a n a
tshika	tsh i k> a
lemogeng	l E m O x E N
betlilweng	b E tl> i l w E N
tlaare	tl> a r E
bakeresete	b a k> E r E s E t> E
bookamedi	b O O k> a m E d i
mašwa	m a S w a
dubisa	d u b i s a
goregore	x O r E x O r E
mpolaisang	m p> O l a i s a N
bolennye	b O l E n J E
thibego	th i b E x O
ditumelelano	d i t> u m E l E l a n O
supiwang	s u p> i w a N
mabapi	m a b a p> i
diphapogo	d i ph a p> O x O
dikapolo	d i k> a p> O l O
forogotlha	f O r O x O tlh a
saeniwa	s a E n i w a
gelele	x E l E l E
isa	i s a
akarediwa	a k> a r E d i w a
thulaganya	th u l a x a J a
dikhilometara	d i kh i l O m E t> a r a
fisioterapi	f i s i O t> E r a p> i
bolabotlhano	b O l a b O tlh a n O
akgoleng	a kx O l E N
tsietsang	ts> i E ts> a N
sefalana	s E f a l a n a
gokaganya	x O k> a x a J a
nkaraba	n k> a r a b a
tseokarolo	ts> E O k> a r O l O
kgotlelego	kx O tl> E l E x O
mmofolola	m m O f O l O l a
mogoloe	m O x O l O E
dikudumedi	d i k> u d u m E d i
ditlamelwana	d i tl> a m E l w a n a
lejwe	l E d0Z w E
ditekesi	d i t> E k> E s i
thaetswe	th a E ts> w E
tsamao	ts> a m a O
maleo	m a l E O
ilweng	i l w E N
konalong	k> O n a l O N
rwale	r w a l E
medithola	m E d i th O l a
mmepeng	m m E p> E N
tswirinya	ts> w i r i J a
rekwe	r E k> w E
badirammogo	b a d i r a m m O x O
tshologang	tsh O l O x a N
phunngwa	ph u n N w a
batlhalefi	b a tlh a l E f i
disha	d i s a
mebotwana	m E b O t> w a n a
dikgwebopotlana	d i kx w E b O p> O tl> a n a
letsogo	l E ts> O x O
kholetšhe	kh O l E tSh E
phatla	ph a tl> a
diragetseng	d i r a x E ts> E N
nowa	n O w a
maikarabelo	m a i k> a r a b E l O
tepo	t> E p> O
gatana	x a t> a n a
ditlhaselo	d i tlh a s E l O
bereke	b E r E k> E
amogwa	a m O x w a
bathusing	b a th u s i N
sekhukhu	s E kh u kh u
fitlheletsweng	f i tlh E l E ts> w E N
intia	i n t> i a
setlhe	s E tlh E
tlhodiwang	tlh O d i w a N
meento	m E E n t> O
tlhokomele	tlh O k> O m E l E
mabone	m a b O n E
bitsang	b i ts> a N
tserweng	ts> E r w E N
sefatlhego	s E f a tlh E x O
tshosang	tsh O s a N
ranolelwa	r a n O l E l w a
betsaka	b E ts> a k> a
setshegetsi	s E tsh E x E ts> i
segopatsela	s E x O p> a ts> E l a
nakonyana	n a k> O J a n a
borraabo	b O r r a b O
maphatsiphatsi	m a ph a ts> i ph a ts> i
disiti	d i s i t> i
kgatselo	kx a ts> E l O
tlhabolotseng	tlh a b O l O ts> E N
lefisa	l E f i s a
emisitse	E m i s i ts> E
khutle	kh u tl> E
bosa	b O s a
tefamorwalo	t> E f a m O r w a l O
dirweng	d i r w E N
diragatswe	d i r a x a ts> w E
nwewang	n w E w a N
selelo	s E l E l O
badirediloago	b a d i r E d i l O a x O
monateng	m O n a t> E N
khukhwane	kh u kh w a n E
baneng	b a n E N
adimiwa	a d i m i w a
ipha	i ph a
dithutiso	d i th u t> i s O
setlhamong	s E tlh a m O N
tlhagafatsa	tlh a x a f a ts> a
laolelwa	l a O l E l w a
mmadi	m m a d i
nitama	n i t> a m a
tlhatlhobegang	tlh a tlh O b E x a N
lotlelwang	l O tl> E l w a N
ditlelempe	d i tl> E l E m p> E
ithabuetsa	i th a b u E ts> a
boroko	b O r O k> O
dumaduma	d u m a d u m a
setlhefala	s E tlh E f a l a
bokgaitsadi	b O kx a i ts> a d i
tlhotlhetsa	tlh O tlh E ts> a
tshetso	tsh E ts> O
saentshe	s a E n tsh E
sekgele	s E kx E l E
jana	d0Z a n a
sutiseng	s u t> i s E N
akaretseng	a k> a r E ts> E N
selwana	s E l w a n a
thobalano	th O b a l a n O
selaole	s E l a O l E
botoro	b O t> O r O
thiboga	th i b O x a
terekere	t> E r E k> E r E
maphodisa	m a ph O d i s a
gagabela	x a x a b E l a
motlhapi	m O tlh a p> i
karabo	k> a r a b O
buiweng	b u i w E N
mmolaya	m m O l a j a
katisang	k> a t> i s a N
dikiletsong	d i k> i l E ts> O N
sebe	s E b E
lerile	l E r i l E
mogaleng	m O x a l E N
ntshwenya	n tsh w E J a
tsereganya	ts> E r E x a J a
ikutlwa	i k> u tl> w a
batlhotlhomisi	b a tlh O tlh O m i s i
phaposong	ph a p> O s O N
rotloetseng	r O tl> O E ts> E N
bontshiwe	b O n tsh i w E
balemirui	b a l E m i r u i
nosiwang	n O s i w a N
phaloso	ph a l O s O
thapang	th a p> a N
kgogophetiso	kx O x O ph E t> i s O
diphatlheng	d i ph a tlh E N
ditogamaanong	d i t> O x a m a n O N
puisong	p> u i s O N
botlhalenyana	b O tlh a l E J a n a
bulega	b u l E x a
laetse	l a E ts> E
diphanele	d i ph a n E l E
lewatleng	l E w a tl> E N
ikgatholosa	i kx a th O l O s a
lesedi	l E s E d i
kaya	k> a j a
tlhanyaolola	tlh a J a O l O l a
dimeleng	d i m E l E N
kwalelana	k> w a l E l a n a
tlhabolole	tlh a b O l O l E
leotong	l E O t> O N
nyorelwa	J O r E l w a
tsidifatso	ts> i d i f a ts> O
pabalesegong	p> a b a l E s E x O N
koloing	k> O l O i N
kubakuba	k> u b a k> u b a
inšorense	i n S O r E n s E
kankereng	k> a n k> E r E N
godisitse	x O d i s i ts> E
baketeria	b a k> E t> E r i a
merwalela	m E r w a l E l a
dintlong	d i n tl> O N
magalamasuge	m a x a l a m a s u x E
fetelwa	f E t> E l w a
difensetere	d i f E n s E t> E r E
manegilwe	m a n E x i l w E
khutlisiwang	kh u tl> i s i w a N
setlhoeng	s E tlh O E N
itsiweng	i ts> i w E N
ikaegileng	i k> a E x i l E N
akaretse	a k> a r E ts> E
lebang	l E b a N
ketapele	k> E t> a p> E l E
heketara	h E k> E t> a r a
bongwang	b O N w a N
lapeng	l a p> E N
tebogo	t> E b O x O
boithaopo	b O i th a O p> O
tlwaeditse	tl> w a E d i ts> E
dibopegong	d i b O p> E x O N
mogopolong	m O x O p> O l O N
thotong	th O t> O N
khombi	kh O m b i
namang	n a m a N
motshodi	m O tsh O d i
ditlamegong	d i tl> a m E x O N
tswako	ts> w a k> O
atolositswe	a t> O l O s i ts> w E
tlisitswe	tl> i s i ts> w E
setsha	s E tsh a
setlhophanyana	s E tlh O ph a J a n a
mabono	m a b O n O
ditsela	d i ts> E l a
ven	b E n
fetela	f E t> E l a
thaelesego	th a E l E S E x O
borobongwe	b O r O b O N w E
dipoelothuto	d i p> O E l O th u t> O
mmoko	m m O k> O
nopolo	n O p> O l O
kopane	k> O p> a n E
tsiya	ts> i j a
bolayang	b O l a j a N
lekiwang	l E k> i w a N
modiragatsi	m O d i r a x a ts> i
moruleng	m O r u l E N
lebagantsweng	l E b a x a n ts> w E N
tlotlegang	tl> O tl> E x a N
sethusi	s E th u s i
moratho	m O r a th O
letswa	l E ts> w a
boikuelo	b O i k> u E l O
kgalo	kx a l O
tebaganyo	t> E b a x a J O
ikakatlela	i k> a k> a tl> E l a
namela	n a m E l a
gogela	x O x E l a
dithipa	d i th i p> a
isegang	i s E x a N
tsietsa	ts> i E ts> a
reka	r E k> a
konoseditseng	k> O n O s E d i ts> E N
logagantsweng	l O x a x a n ts> w E N
morwaarona	m O r w a r O n a
bokidi	b O k> i d i
maledu	m a l E d u
sentswe	s E n ts> w E
amana	a m a n a
dipekereng	d i p> E k> E r E N
sekae	s E k> a E
bao	b a O
menagana	m E n a x a n a
etang	E t> a N
semorafe	s E m O r a f E
ipuisetsa	i p> u i s E ts> a
tsibogeleng	ts> i b O x E l E N
bopile	b O p> i l E
dipolelong	d i p> O l E l O N
robiwa	r O b i w a
kgwathana	kx w a th a n a
laele	l a E l E
senyana	s E J a n a
bonni	b O n n i
sekaka	s E k> a k> a
bakwadisi	b a k> w a d i s i
golotswe	x O l O ts> w E
builwe	b u i l w E
ikgapele	i kx a p> E l E
dikganelo	d i kx a n E l O
letsele	l E ts> E l E
fekeseng	f E k> E s E N
diripana	d i r i p> a n a
epiwang	E p> i w a N
roroma	r O r O m a
dikgano	d i kx a n O
phatlalatsang	ph a tl> a l a ts> a N
thekenolojing	th E k> E n O l O d0Z i N
kamogelong	k> a m O x E l O N
legodu	l E x O d u
nagagodimo	n a x a x O d i m O
thibetswe	th i b E ts> w E
boi	b O i
fositse	f O s i ts> E
abelanwang	a b E l a n w a N
lemao	l E m a O
lelekisa	l E l E k> i s a
mmusisi	m m u s i s i
diatelo	d i a t> E l O
sefatlhegong	s E f a tlh E x O N
bolang	b O l a N
tlale	tl> a l E
mothapi	m O th a p> i
meeding	m E E d i N
kgetseng	kx E ts> E N
tirisanommogong	t> i r i s a n O m m O x O N
tlhodilweng	tlh O d i l w E N
ratega	r a t> E x a
agelwang	a x E l w a N
sedimosediwa	s E d i m O s E d i w a
lekolwa	l E k> O l w a
bonno	b O n n O
magoletsa	m a x O l E ts> a
tsamaile	ts> a m a i l E
nja	n d0Z a
tshitshinyong	tsh i tsh i J O N
lomaganye	l O m a x a J E
barutwaneng	b a r u t> w a n E N
betwa	b E t> w a
kutung	k> u t> u N
busetse	b u s E ts> E
nkeletsa	n k> E l E ts> a
tlhobaela	tlh O b a E l a
motšhotšhisi	m O tSh O tSh i s i
amogelegileng	a m O x E l E x i l E N
dingwageng	d i N w a x E N
mahibidu	m a h i b i d u
athikele	a th i k> E l E
bolemisi	b O l E m i s i
matlwana	m a tl> w a n a
reediwe	r E E d i w E
pharakano	ph a r a k> a n O
iphetlha	i ph E tlh a
lemogwang	l E m O x w a N
swedietega	s w E d i E t> E x a
phaposo	ph a p> O s O
tsoma	ts> O m a
gapilwe	x a p> i l w E
ntetle	n t> E tl> E
fetoletsweng	f E t> O l E ts> w E N
letetse	l E t> E ts> E
tsholeditswe	tsh O l E d i ts> w E
diradiong	d i r a d i O N
magetla	m a x E tl> a
tlhakatlhakane	tlh a k> a tlh a k> a n E
polasing	p> O l a s i N
tlhagetseng	tlh a x E ts> E N
dikanelo	d i k> a n E l O
ferekana	f E r E k> a n a
seela	s E E l a
boithaopi	b O i th a O p> i
morobi	m O r O b i
tshelegelwa	tsh E l E x E l w a
marurung	m a r u r u N
matšhaena	m a tSh a E n a
ntsaya	n ts> a j a
molelwaneng	m O l E l w a n E N
sometlhano	s O m E tlh a n O
mabala	m a b a l a
kgatlhilwe	kx a tlh i l w E
dipokanong	d i p> O k> a n O N
gobelelang	x O b E l E l a N
tekelo	t> E k> E l O
maragonyana	m a r a x O J a n a
tsamaelano	ts> a m a E l a n O
tlhokisang	tlh O k> i s a N
obotse	O b O ts> E
botlase	b O tl> a s E
rotloetsa	r O tl> O E ts> a
mogoteng	m O x O t> E N
ikanyego	i k> a J E x O
hudugela	h u d u x E l a
kgorelediwa	kx O r E l E d i w a
buelela	b u E l E l a
okobala	O k> O b a l a
matlhakore	m a tlh a k> O r E
losika	l O s i k> a
kwaleng	k> w a l E N
kopanyo	k> O p> a J O
natefelwe	n a t> E f E l w E
melapo	m E l a p> O
segerika	s E x E r i k> a
sekolotong	s E k> O l O t> O N
dikabelong	d i k> a b E l O N
thutapuo	th u t> a p> u O
tebelopele	t> E b E l O p> E l E
diilwe	d i i l w E
tshedile	tsh E d i l E
dikgolwane	d i kx O l w a n E
jwalang	d0Z w a l a N
bonnong	b O n n O N
setlhopha	s E tlh O ph a
bokamosong	b O k> a m O s O N
thelesetso	th E l E s E ts> O
mosibudi	m O s i b u d i
modiredipuso	m O d i r E d i p> u s O
sekhutlo	s E kh u tl> O
dipoloma	d i p> O l O m a
babadi	b a b a d i
gapeletsang	x a p> E l E ts> a N
sedimositsweng	s E d i m O s i ts> w E N
kotlhaong	k> O tlh a O N
dikatlego	d i k> a tl> E x O
difantising	d i f a n t> i s i N
supetsa	s u p> E ts> a
rekelang	r E k> E l a N
tlhajwe	tlh a d0Z w E
infoleišene	i n f O l E i S E n E
latofadiwang	l a t> O f a d i w a N
beeleditse	b E E l E d i ts> E
minolosa	m i n O l O s a
atlana	a tl> a n a
sekasekelwang	s E k> a s E k> E l w a N
gobadiwa	x O b a d i w a
diphatlha	d i ph a tlh a
kaneding	k> a n E d i N
tetlelo	t> E tl> E l O
anamisiwa	a n a m i s i w a
phopholego	ph O ph O l E x O
nkwe	n k> w E
iletsa	i l E ts> a
fedisiwa	f E d i s i w a
ditsebetsebe	d i ts> E b E ts> E b E
tlhaeletsanang	tlh a E l E ts> a n a N
nke	n k> E
itshepa	i tsh E p> a
dikaing	d i k> a i N
botaki	b O t> a k> i
rotloetswa	r O tl> O E ts> w a
phasalalo	ph a s a l a l O
bontshitsweng	b O n tsh i ts> w E N
tlaa	tl> a
mogote	m O x O t> E
sanetasi	s a n E t> a s i
relela	r E l E l a
mokwadi	m O k> w a d i
gorarabolola	x O r a r a b O l O l a
kgobalang	kx O b a l a N
sepatšhe	s E p> a tSh E
legadima	l E x a d i m a
mogwere	m O x w E r E
diragaditse	d i r a x a d i ts> E
kgopololo	kx O p> O l O l O
amogetse	a m O x E ts> E
laleditse	l a l E d i ts> E
ithaya	i th a j a
lethekeng	l E th E k> E N
iphitlha	i ph i tlh a
ikano	i k> a n O
khemo	kh E m O
dithuto	d i th u t> O
gobadiwang	x O b a d i w a N
tsoga	ts> O x a
rarabololang	r a r a b O l O l a N
faboriking	f a b O r i k> i N
diforamong	d i f O r a m O N
dipotso	d i p> O ts> O
bolokwa	b O l O k> w a
akanyeditsweng	a k> a J E d i ts> w E N
ramolao	r a m O l a O
otlhaiwang	O tlh a i w a N
ntshiwang	n tsh i w a N
boruni	b O r u n i
itshekisa	i tsh E k> i s a
kwadisiwang	k> w a d i s i w a N
aname	a n a m E
diforomong	d i f O r O m O N
modirisi	m O d i r i s i
swabang	s w a b a N
sešweng	s E S w E N
thulagano	th u l a x a n O
ditumelo	d i t> u m E l O
kgopisa	kx O p> i s a
kapeso	k> a p> E s O
tlhobaelang	tlh O b a E l a N
kgosi	kx O s i
mafokonyana	m a f O k> O J a n a
matloleng	m a tl> O l E N
poelo	p> O E l O
marata	m a r a t> a
omisang	O m i s a N
pinagareng	p> i n a x a r E N
bolwetse	b O l w E ts> E
memetso	m E m E ts> O
bouto	b O u t> O
mokgotledi	m O kx O tl> E d i
fete	f E t> E
lepatlelo	l E p> a tl> E l O
tshutiso	tsh u t> i s O
sia	s i a
rekilwe	r E k> i l w E
lemena	l E m E n a
laolang	l a O l a N
polokong	p> O l O k> O N
dithabeng	d i th a b E N
tona	t> O n a
bafetoledi	b a f E t> O l E d i
bontshana	b O n tsh a n a
tshegetse	tsh E x E ts> E
farologanngwang	f a r O l O x a n N w a N
kgethololwa	kx E th O l O l w a
ngwanyana	N w a J a n a
rekisitsweng	r E k> i s i ts> w E N
khabareitara	kh a b a r E i t> a r a
lengope	l E N O p> E
potlaka	p> O tl> a k> a
katologana	k> a t> O l O x a n a
ikaniso	i k> a n i s O
ureng	u r E N
tshipi	tsh i p> i
dirisitse	d i r i s i ts> E
tlhomamisong	tlh O m a m i s O N
phatlheng	ph a tlh E N
kgweetsang	kx w E E ts> a N
ikamanye	i k> a m a J E
kgoreletso	kx O r E l E ts> O
matikiri	m a t> i k> i r i
marose	m a r O s E
dikhutshwe	d i kh u tsh w E
thapama	th a p> a m a
alafegang	a l a f E x a N
nyalelanang	J a l E l a n a N
lebilwe	l E b i l w E
mmakatsa	m m a k> a ts> a
mekgokolosa	m E kx O k> O l O s a
tlhageletseng	tlh a x E l E ts> E N
tlhalosegang	tlh a l O s E x a N
ipetlela	i p> E tl> E l a
thota	th O t> a
seng	s E N
mokibo	m O k> i b O
madi	m a d i
lekese	l E k> E s E
diporofense	d i p> O r O f E n s E
kgosikgolo	kx O s i kx O l O
dithata	d i th a t> a
thiba	th i b a
batlegang	b a tl> E x a N
meleele	m E l E E l E
segwapa	s E x w a p> a
felelwa	f E l E l w a
mookameding	m O O k> a m E d i N
thuntshe	th u n tsh E
ntswalang	n ts> w a l a N
kholomong	kh O l O m O N
mathompo	m a th O m p> O
leotwana	l E O t> w a n a
ikgone	i kx O n E
boamogelo	b O a m O x E l O
tlhakanetsweng	tlh a k> a n E ts> w E N
ditikologong	d i t> i k> O l O x O N
okeditse	O k> E d i ts> E
bagolwane	b a x O l w a n E
maitirelo	m a i t> i r E l O
itekela	i t> E k> E l a
matlhabisaditlhong	m a tlh a b i s a d i tlh O N
kgamilwe	kx a m i l w E
tumelelano	t> u m E l E l a n O
laleditswe	l a l E d i ts> w E
moepong	m O E p> O N
bokwadi	b O k> w a d i
nepagatseng	n E p> a x a ts> E N
tsalela	ts> a l E l a
tsebentlha	ts> E b E n tlh a
balela	b a l E l a
kgwatlha	kx w a tlh a
diphuka	d i ph u k> a
keleka	k> E l E k> a
tsweledisiwang	ts> w E l E d i s i w a N
intshe	i n tsh E
kgatsho	kx a tsh O
bodilong	b O d i l O N
masimo	m a s i m O
goang	x O a N
itemogelang	i t> E m O x E l a N
thusopotlako	th u s O p> O tl> a k> O
thuntse	th u n ts> E
mathateng	m a th a t> E N
badiri	b a d i r i
serobe	s E r O b E
lekgotlataolo	l E kx O tl> a t> a O l O
tshegetsong	tsh E x E ts> O N
rulagantseng	r u l a x a n ts> E N
kopa	k> O p> a
owaai	O w a i
emelelang	E m E l E l a N
ditiragatso	d i t> i r a x a ts> O
otong	O t> O N
dinyaga	d i J a x a
moatlhodisi	m O a tlh O d i s i
momaganeng	m O m a x a n E N
ditekanyetsokabo	d i t> E k> a J E ts> O k> a b O
fodisang	f O d i s a N
phimolo	ph i m O l O
pelokgale	p> E l O kx a l E
iponetse	i p> O n E ts> E
maitsetsepelo	m a i ts> E ts> E p> E l O
dikokelo	d i k> O k> E l O
petse	p> E ts> E
tiego	t> i E x O
sego	s E x O
baletsweng	b a l E ts> w E N
letlhakoreng	l E tlh a k> O r E N
ditlhapa	d i tlh a p> a
sepoko	s E p> O k> O
itshiametseng	i tsh i a m E ts> E N
robale	r O b a l E
bopiwa	b O p> i w a
legolwane	l E x O l w a n E
ikatisong	i k> a t> i s O N
letamong	l E t> a m O N
laela	l a E l a
phasaladiwang	ph a s a l a d i w a N
tsorotla	ts> O r O tl> a
