kgapetse	kx a p> E ts> E
jenale	d0Z E n a l E
sekileng	s E k> i l E N
maitsholong	m a i tsh O l O N
tlhotlholetso	tlh O tlh O l E ts> O
sila	s i l a
rutile	r u t> i l E
tshwerweng	tsh w E r w E N
botlana	b O tl> a n a
seripana	s E r i p> a n a
tlwaeditswe	tl> w a E d i ts> w E
sekurufu	s E k> u r u f u
lebokoso	l E b O k> O s O
retetse	r E t> E ts> E
kolopela	k> O l O p> E l a
diduti	d i d u t> i
esele	E s E l E
leele	l E E l E
ngodiega	N O d i E x a
phate	ph a t> E
maikatlapelo	m a i k> a tl> a p> E l O
tlou	tl> O u
kgatlhong	kx a tlh O N
tlhanye	tlh a J E
ntapisitse	n t> a p> i s i ts> E
dithotaneng	d i th O t> a n E N
ntsha	n tsh a
mmakgomotso	m m a kx O m O ts> O
omana	O m a n a
moithuting	m O i th u t> i N
thaologo	th a O l O x O
nakeng	n a k> E N
makgetlo	m a kx E tl> O
ditshikeng	d i tsh i k> E N
ditlogolwana	d i tl> O x O l w a n a
ditetla	d i t> E tl> a
thari	th a r i
tlhage	tlh a x E
ntshiwa	n tsh i w a
matlhogole	m a tlh O x O l E
okamang	O k> a m a N
ikuelwang	i k> u E l w a N
rejisetareng	r E d0Z i s E t> a r E N
tshololelwang	tsh O l O l E l w a N
matsholong	m a tsh O l O N
setlhotshwana	s E tlh O tsh w a n a
romele	r O m E l E
godisa	x O d i s a
ithotloetsa	i th O tl> O E ts> a
matlotlo	m a tl> O tl> O
dipineng	d i p> i n E N
dipoelethuto	d i p> O E l E th u t> O
tsenwa	ts> E n w a
nkamoga	n k> a m O x a
dintlo	d i n tl> O
dimitara	d i m i t> a r a
ganwang	x a n w a N
kontinente	k> O n t> i n E n t> E
tsenngwa	ts> E n N w a
dithibololo	d i th i b O l O l O
moseti	m O s E t> i
phaposing	ph a p> O s i N
moleta	m O l E t> a
apeele	a p> E E l E
ditumediso	d i t> u m E d i s O
pateletswang	p> a t> E l E ts> w a N
leotwaneng	l E O t> w a n E N
kerafong	k> E r a f O N
tshwenngwa	tsh w E n N w a
tshole	tsh O l E
botsogo	b O ts> O x O
reke	r E k> E
kileng	k> i l E N
mannye	m a n J E
papetla	p> a p> E tl> a
leano	l E a n O
dipaki	d i p> a k> i
diragalang	d i r a x a l a N
maboko	m a b O k> O
diphaka	d i ph a k> a
tladika	tl> a d i k> a
tlhalano	tlh a l a n O
lolamisiwa	l O l a m i s i w a
segokaganyi	s E x O k> a x a J i
elelela	E l E l E l a
tlhalosege	tlh a l O s E x E
maikotlhao	m a i k> O tlh a O
lekanetseng	l E k> a n E ts> E N
maetong	m a E t> O N
porouse	p> O r O u s E
ntshetseng	n tsh E ts> E N
atlholetsweng	a tlh O l E ts> w E N
thadisetsa	th a d i s E ts> a
thutalefatshe	th u t> a l E f a tsh E
diteko	d i t> E k> O
ikaelang	i k> a E l a N
meepong	m E E p> O N
nopotse	n O p> O ts> E
tshetledi	tsh E tl> E d i
kotulong	k> O t> u l O N
itsiwa	i ts> i w a
monnao	m O n n a O
ditshwetso	d i tsh w E ts> O
matlhabaphefo	m a tlh a b a ph E f O
thibololo	th i b O l O l O
gomotsega	x O m O ts> E x a
boitlhobogong	b O i tlh O b O x O N
boene	b O E n E
boladu	b O l a d u
marakanelong	m a r a k> a n E l O N
dirapa	d i r a p> a
maitsholo	m a i tsh O l O
bofefo	b O f E f O
khwalifayang	kh w a l i f a j a N
baarabi	b a r a b i
segaswa	s E x a s w a
quin	k> w i n
kgarakgatshe	kx a r a kx a tsh E
tlhophololo	tlh O ph O l O l O
makukunopung	m a k> u k> u n O p> u N
letleletse	l E tl> E l E ts> E
dinwamadi	d i n w a m a d i
abuti	a b u t> i
thobalanong	th O b a l a n O N
dikgato	d i kx a t> O
nno	n n O
ntswela	n ts> w E l a
khumong	kh u m O N
rapaletseng	r a p> a l E ts> E N
letleletswe	l E tl> E l E ts> w E
kalo	k> a l O
balwetse	b a l w E ts> E
apaya	a p> a j a
tirisopuo	t> i r i s O p> u O
bogale	b O x a l E
ntšhafatsa	n tSh a f a ts> a
kolotsana	k> O l O ts> a n a
borutelo	b O r u t> E l O
tsidifalang	ts> i d i f a l a N
tlhokafaletswe	tlh O k> a f a l E ts> w E
nnyaya	n J a j a
ikemisetse	i k> E m i s E ts> E
maipofo	m a i p> O f O
tseneletsweng	ts> E n E l E ts> w E N
sobokanya	s O b O k> a J a
kgogomogo	kx O x O m O x O
sediko	s E d i k> O
efe	E f E
mmueleding	m m u E l E d i N
meding	m E d i N
bolaiwa	b O l a i w a
tsepameng	ts> E p> a m E N
tshekatsheko	tsh E k> a tsh E k> O
jalwa	d0Z a l w a
bobolokelo	b O b O l O k> E l O
tsomela	ts> O m E l a
selemo	s E l E m O
thatafatsang	th a t> a f a ts> a N
borakanelo	b O r a k> a n E l O
thibosa	th i b O s a
kgabo	kx a b O
kgabaganye	kx a b a x a J E
nosetsong	n O s E ts> O N
palamente	p> a l a m E n t> E
karata	k> a r a t> a
laboratoring	l a b O r a t> O r i N
kamanong	k> a m a n O N
morabaraba	m O r a b a r a b a
phedisa	ph E d i s a
neelong	n E E l O N
kapeo	k> a p> E O
kokoantseng	k> O k> O a n ts> E N
gopotseng	x O p> O ts> E N
thaletsweng	th a l E ts> w E N
sesading	s E s a d i N
tlhotlheletso	tlh O tlh E l E ts> O
kokoanyang	k> O k> O a J a N
latlhilwe	l a tlh i l w E
folosediwa	f O l O s E d i w a
itšhuu	i tSh u u
potlakile	p> O tl> a k> i l E
bommemogolo	b O m m E m O x O l O
tsamaisong	ts> a m a i s O N
moalo	m O a l O
dipeelano	d i p> E E l a n O
diphegelelo	d i ph E x E l E l O
motako	m O t> a k> O
thapiwang	th a p> i w a N
hularele	h u l a r E l E
kitso	k> i ts> O
sutela	s u t> E l a
ongwe	O N w E
bolokiwe	b O l O k> i w E
tsidifala	ts> i d i f a l a
opela	O p> E l a
nelwa	n E l w a
tlhamalalo	tlh a m a l a l O
boba	b O b a
ketefalelwa	k> E t> E f a l E l w a
batswakwa	b a ts> w a k> w a
rayang	r a j a N
didiriswa	d i d i r i s w a
gouta	x O u t> a
itsemeletsang	i ts> E m E l E ts> a N
baithuting	b a i th u t> i N
bediwang	b E d i w a N
palamonwana	p> a l a m O n w a n a
mafaratlhatlheng	m a f a r a tlh a tlh E N
bathong	b a th O N
mhama	m h a m a
ntlolehalahala	n tl> O l E h a l a h a l a
setoro	s E t> O r O
mekamekanang	m E k> a m E k> a n a N
tlogelela	tl> O x E l E l a
gapiwang	x a p> i w a N
obola	O b O l a
goletse	x O l E ts> E
robatsa	r O b a ts> a
tshwerwe	tsh w E r w E
okame	O k> a m E
ditsaleng	d i ts> a l E N
ikgapetse	i kx a p> E ts> E
peiso	p> E i s O
tshwanetseng	tsh w a n E ts> E N
lesomong	l E s O m O N
dinokaneng	d i n O k> a n E N
lerileng	l E r i l E N
tlhokomologile	tlh O k> O m O l O x i l E
diterekere	d i t> E r E k> E r E
diragadiwe	d i r a x a d i w E
diragalelang	d i r a x a l E l a N
dikgatako	d i kx a t> a k> O
tshwaeditswe	tsh w a E d i ts> w E
bokafantle	b O k> a f a n tl> E
thakgaletse	th a kx a l E ts> E
dikhosong	d i kh O s O N
moloi	m O l O i
bokhutlong	b O kh u tl> O N
iteka	i t> E k> a
retwa	r E t> w a
tekatlhaloganyo	t> E k> a tlh a l O x a J O
dipono	d i p> O n O
koko	k> O k> O
tlhopho	tlh O ph O
iphitlhang	i ph i tlh a N
tlhaetse	tlh a E ts> E
patlo	p> a tl> O
sephara	s E ph a r a
fuduge	f u d u x E
merero	m E r E r O
kgotle	kx O tl> E
thubakanyo	th u b a k> a J O
setileng	s E t> i l E N
kabu	k> a b u
fatlhwang	f a tlh w a N
lata	l a t> a
legolong	l E x O l O N
umakilweng	u m a k> i l w E N
neilwe	n E i l w E
bolelele	b O l E l E l E
latlhwe	l a tlh w E
dipente	d i p> E n t> E
tlholeng	tlh O l E N
fitlhelelwang	f i tlh E l E l w a N
lehumeng	l E h u m E N
theogetse	th E O x E ts> E
elelelang	E l E l E l a N
romelele	r O m E l E l E
reetseng	r E E ts> E N
sefololetse	s E f O l O l E ts> E
lesomepedi	l E s O m E p> E d i
tlhokomelwa	tlh O k> O m E l w a
dikhutlo	d i kh u tl> O
ntshwabisitse	n tsh w a b i s i ts> E
mmung	m m u N
kemonosi	k> E m O n O s i
bohibidu	b O h i b i d u
khudugo	kh u d u x O
kgatelelong	kx a t> E l E l O N
seterese	s E t> E r E s E
phapang	ph a p> a N
gane	x a n E
tsomana	ts> O m a n a
rekota	r E k> O t> a
boitshepi	b O i tsh E p> i
belega	b E l E x a
tlhaeletsano	tlh a E l E ts> a n O
kgatisogape	kx a t> i s O x a p> E
saense	s a E n s E
segolobogolo	s E x O l O b O x O l O
kobego	k> O b E x O
foreiming	f O r E i m i N
mebusong	m E b u s O N
moruti	m O r u t> i
tlhakatlhakanya	tlh a k> a tlh a k> a J a
balaodi	b a l a O d i
phomolong	ph O m O l O N
tlamelelang	tl> a m E l E l a N
loapi	l O a p> i
tshenekeging	tsh E n E k> E x i N
etetsweng	E t> E ts> w E N
kgoreletse	kx O r E l E ts> E
rebolela	r E b O l E l a
photho	ph O th O
molaong	m O l a O N
letlhotlholo	l E tlh O tlh O l O
petula	p> E t> u l a
motsayakarolo	m O ts> a j a k> a r O l O
emise	E m i s E
motsamao	m O ts> a m a O
kgotsofadiwe	kx O ts> O f a d i w E
seroring	s E r O r i N
mapodising	m a p> O d i s i N
phetisi	ph E t> i s i
matsekeng	m a ts> E k> E N
tshenyegelong	tsh E J E x E l O N
pholoso	ph O l O s O
seelo	s E E l O
thulaganyong	th u l a x a J O N
nkwana	n k> w a n a
itirele	i t> i r E l E
filosofi	f i l O s O f i
dikhoso	d i kh O s O
kgetholole	kx E th O l O l E
tlhoetse	tlh O E ts> E
pholwana	ph O l w a n a
botlhapelo	b O tlh a p> E l O
thamele	th a m E l E
feditse	f E d i ts> E
boganka	b O x a n k> a
sekala	s E k> a l a
dikhiro	d i kh i r O
tswile	ts> w i l E
lentšhwa	l E n tSh w a
disenying	d i s E J i N
metlotseding	m E tl> O ts> E d i N
sethosa	s E th O s a
selennere	s E l E n n E r E
masepala	m a s E p> a l a
tshwantsheditse	tsh w a n tsh E d i ts> E
sikare	s i k> a r E
letsetsa	l E ts> E ts> a
phatwe	ph a t> w E
disente	d i s E n t> E
diromo	d i r O m O
mopalami	m O p> a l a m i
bogare	b O x a r E
sešeng	s E S E N
kgare	kx a r E
mmepe	m m E p> E
tokafatsang	t> O k> a f a ts> a N
gatsedisa	x a ts> E d i s a
tsalong	ts> a l O N
lomagana	l O m a x a n a
boeteledipeleng	b O E t> E l E d i p> E l E N
baakantsweng	b a k> a n ts> w E N
boitemogelo	b O i t> E m O x E l O
mmaayo	m m a j O
aparo	a p> a r O
tlhabolola	tlh a b O l O l a
nositsweng	n O s i ts> w E N
dipota	d i p> O t> a
dino	d i n O
mmapa	m m a p> a
iphimotse	i ph i m O ts> E
mpatla	m p> a tl> a
batliwe	b a tl> i w E
tshwaya	tsh w a j a
tlhabego	tlh a b E x O
motshwareledi	m O tsh w a r E l E d i
motsofe	m O ts> O f E
ditshepiso	d i tsh E p> i s O
phakang	ph a k> a N
tlhaloganngwang	tlh a l O x a n N w a N
faposiwe	f a p> O s i w E
simolole	s i m O l O l E
diroboto	d i r O b O t> O
iteleketseng	i t> E l E k> E ts> E N
dintsanantsana	d i n ts> a n a n ts> a n a
itshamekela	i tsh a m E k> E l a
fosa	f O s a
kgaole	kx a O l E
ketekela	k> E t> E k> E l a
fekeetsang	f E k> E E ts> a N
ikgotsofatse	i kx O ts> O f a ts> E
oma	O m a
tsepamisitse	ts> E p> a m i s i ts> E
ratha	r a th a
lesometlhano	l E s O m E tlh a n O
kgatshong	kx a tsh O N
leruri	l E r u r i
rotloediwang	r O tl> O E d i w a N
otlhaelwa	O tlh a E l w a
melaotheo	m E l a O th E O
kgweeletsa	kx w E E l E ts> a
etleeditsweng	E tl> E E d i ts> w E N
meboto	m E b O t> O
ngololo	N O l O l O
ngata	N a t> a
ratiwang	r a t> i w a N
phothoselo	ph O th O s E l O
thanoding	th a n O d i N
sileng	s i l E N
ilwang	i l w a N
kopo	k> O p> O
meago	m E a x O
ditefelo	d i t> E f E l O
khemising	kh E m i s i N
seke	s E k> E
thaereng	th a E r E N
itshokela	i tsh O k> E l a
tseelwe	ts> E E l w E
ditshelo	d i tsh E l O
tlogelelwa	tl> O x E l E l w a
reeditseng	r E E d i ts> E N
itshegeleditseng	i tsh E x E l E d i ts> E N
thuthugileng	th u th u x i l E N
bajadi	b a d0Z a d i
lekanye	l E k> a J E
kgwa	kx w a
gopolelwa	x O p> O l E l w a
golegwe	x O l E x w E
phepafatsang	ph E p> a f a ts> a N
tsibogelong	ts> i b O x E l O N
tshwanele	tsh w a n E l E
mabaibai	m a b a i b a i
mekgweng	m E kx w E N
dikapeso	d i k> a p> E s O
rorisa	r O r i s a
akhaontong	a kh a O n t> O N
fediwa	f E d i w a
laisang	l a i s a N
ikarabelela	i k> a r a b E l E l a
tleliniking	tl> E l i n i k> i N
netefaletsong	n E t> E f a l E ts> O N
laolega	l a O l E x a
semikana	s E m i k> a n a
matlhodi	m a tlh O d i
eletsega	E l E ts> E x a
dikoketso	d i k> O k> E ts> O
kgobokanngwa	kx O b O k> a n N w a
fetoga	f E t> O x a
ditshwantshetso	d i tsh w a n tsh E ts> O
selekanyetso	s E l E k> a J E ts> O
marota	m a r O t> a
baphepafatsi	b a ph E p> a f a ts> i
dikepo	d i k> E p> O
tlisa	tl> i s a
ao	a O
ahaa	a h a a
rolo	r O l O
tlhaloganngwe	tlh a l O x a n N w E
beeletswa	b E E l E ts> w a
gapelesege	x a p> E l E s E x E
boradikonteraka	b O r a d i k> O n t> E r a k> a
phatlaladitswe	ph a tl> a l a d i ts> w E
kgotlhokgotsa	kx O tlh O kx O ts> a
lemogwe	l E m O x w E
kgaratlhong	kx a r a tlh O N
ketekwe	k> E t> E k> w E
tlhatlhobo	tlh a tlh O b O
nkutlwa	n k> u tl> w a
tshwanang	tsh w a n a N
thusiwa	th u s i w a
itsisa	i ts> i s a
melapong	m E l a p> O N
tswalelwe	ts> w a l E l w E
sutisetsa	s u t> i s E ts> a
baakangwa	b a k> a N w a
matsorotsoro	m a ts> O r O ts> O r O
dilwana	d i l w a n a
tlhokomelana	tlh O k> O m E l a n a
robalana	r O b a l a n a
amogelwa	a m O x E l w a
tuu	t> u u
boimana	b O i m a n a
akaretsang	a k> a r E ts> a N
tlhomamang	tlh O m a m a N
baalafi	b a l a f i
phese	ph E s E
diragatswang	d i r a x a ts> w a N
tlhagisa	tlh a x i s a
dikgong	d i kx O N
tlaletswe	tl> a l E ts> w E
khunologong	kh u n O l O x O N
tsepamise	ts> E p> a m i s E
entiwang	E n t> i w a N
dikholeji	d i kh O l E d0Z i
dikutu	d i k> u t> u
bojannye	b O d0Z a n J E
lebolelamading	l E b O l E l a m a d i N
itshwarelwa	i tsh w a r E l w a
maiding	m a i d i N
letangwaneng	l E t> a N w a n E N
galakang	x a l a k> a N
tlotliwa	tl> O tl> i w a
nnyane	n J a n E
disilintara	d i s i l i n t> a r a
tseelana	ts> E E l a n a
botsetse	b O ts> E ts> E
tshamekang	tsh a m E k> a N
itlwaetse	i tl> w a E ts> E
senolwa	s E n O l w a
tlhomologileng	tlh O m O l O x i l E N
motlhana	m O tlh a n a
namatshego	n a m a tsh E x O
ikgonang	i kx O n a N
bogologolong	b O x O l O x O l O N
abelana	a b E l a n a
kago	k> a x O
maitseboeng	m a i ts> E b O E N
phimolega	ph i m O l E x a
mpolelela	m p> O l E l E l a
tebang	t> E b a N
tsielegong	ts> i E l E x O N
losea	l O s E a
tswakanngwa	ts> w a k> a n N w a
thapeng	th a p> E N
paletsweng	p> a l E ts> w E N
meferong	m E f E r O N
obe	O b E
ikaego	i k> a E x O
letlalong	l E tl> a l O N
gakgamala	x a kx a m a l a
dikhutshwane	d i kh u tsh w a n E
thibelwe	th i b E l w E
motlhankedimogolo	m O tlh a n k> E d i m O x O l O
botsatsa	b O ts> a ts> a
moso	m O s O
bolekane	b O l E k> a n E
tshiamong	tsh i a m O N
lenaga	l E n a x a
lale	l a l E
dikgakologo	d i kx a k> O l O x O
tlotlofoko	tl> O tl> O f O k> O
okediwe	O k> E d i w E
menate	m E n a t> E
yone	j O n E
motaki	m O t> a k> i
koafetseng	k> O a f E ts> E N
tokologo	t> O k> O l O x O
tsholola	tsh O l O l a
fetolang	f E t> O l a N
botlhaba	b O tlh a b a
ditshenyegelo	d i tsh E J E x E l O
kganetso	kx a n E ts> O
tsweleletseng	ts> w E l E l E ts> E N
apeelang	a p> E E l a N
terameng	t> E r a m E N
fisitseng	f i s i ts> E N
bona	b O n a
boporofesa	b O p> O r O f E s a
kelotlhoko	k> E l O tlh O k> O
makgaokgao	m a kx a O kx a O
botshwarweng	b O tsh w a r w E N
batlegeng	b a tl> E x E N
godileng	x O d i l E N
supelwang	s u p> E l w a N
kgwele	kx w E l E
dithuso	d i th u s O
fitlheletseng	f i tlh E l E ts> E N
duelelweng	d u E l E l w E N
baagisane	b a x i s a n E
bokana	b O k> a n a
fufulelelwa	f u f u l E l E l w a
diemong	d i E m O N
kgethololong	kx E th O l O l O N
megolo	m E x O l O
sephuthelwaneng	s E ph u th E l w a n E N
diraleng	d i r a l E N
lotsong	l O ts> O N
dithanoding	d i th a n O d i N
lebeletswe	l E b E l E ts> w E
makgabaganyo	m a kx a b a x a J O
ditsuane	d i ts> u a n E
kwadiwa	k> w a d i w a
dikgapo	d i kx a p> O
moweng	m O w E N
seedi	s E E d i
borongwa	b O r O N w a
khutlotharo	kh u tl> O th a r O
moreromogolo	m O r E r O m O x O l O
rulagana	r u l a x a n a
balemising	b a l E m i s i N
terata	t> E r a t> a
rotse	r O ts> E
laetsa	l a E ts> a
gobetse	x O b E ts> E
nyenyefatsa	J E J E f a ts> a
bolotloa	b O l O tl> O a
laolesegang	l a O l E s E x a N
dikgatlhego	d i kx a tlh E x O
ntomile	n t> O m i l E
karolokgolo	k> a r O l O kx O l O
lefe	l E f E
tlhakanetswe	tlh a k> a n E ts> w E
roromang	r O r O m a N
nemeru	n E m E r u
ipoditse	i p> O d i ts> E
ditatelelo	d i t> a t> E l E l O
bokgakala	b O kx a k> a l a
thape	th a p> E
gwetlhileng	x w E tlh i l E N
tselatshweu	ts> E l a tsh w E u
nkgopola	n kx O p> O l a
tsenwang	ts> E n w a N
kgologolo	kx O l O x O l O
kwalele	k> w a l E l E
bolaileng	b O l a i l E N
lebelo	l E b E l O
moatlhodi	m O a tlh O d i
tlhabana	tlh a b a n a
tselafefo	ts> E l a f E f O
moagisaning	m O a x i s a n i N
sedifatse	s E d i f a ts> E
mogoso	m O x O s O
babalesegileng	b a b a l E s E x i l E N
emetsweng	E m E ts> w E N
tlhomama	tlh O m a m a
maikano	m a i k> a n O
sejaro	s E d0Z a r O
tlapukeng	tl> a p> u k> E N
rutilwe	r u t> i l w E
thubegile	th u b E x i l E
tsholeditsweng	tsh O l E d i ts> w E N
rasiting	r a s i t> i N
fenngwe	f E n N w E
okamela	O k> a m E l a
kalana	k> a l a n a
tlhatlhobong	tlh a tlh O b O N
sebeteng	s E b E t> E N
lefifi	l E f i f i
tšhonong	tSh O n O N
phepafaditsweng	ph E p> a f a d i ts> w E N
dikerafo	d i k> E r a f O
boleo	b O l E O
rotloeditsweng	r O tl> O E d i ts> w E N
sejeremane	s E d0Z E r E m a n E
bosomepedi	b O s O m E p> E d i
paakanyong	p> a k> a J O N
bosula	b O s u l a
tsamaelanang	ts> a m a E l a n a N
kgotlang	kx O tl> a N
boboi	b O b O i
tlhakatlhakano	tlh a k> a tlh a k> a n O
malebo	m a l E b O
bohumi	b O h u m i
maikarabelong	m a i k> a r a b E l O N
konosetse	k> O n O s E ts> E
tlhakane	tlh a k> a n E
utlwisiwa	u tl> w i s i w a
pho	ph O
kgethologo	kx E th O l O x O
ope	O p> E
rukhutlhe	r u kh u tlh E
laola	l a O l a
matshwititshwiti	m a tsh w i t> i tsh w i t> i
tshisinya	tsh i s i J a
dikgatlegelo	d i kx a tl> E x E l O
heela	h E E l a
ipoeletsang	i p> O E l E ts> a N
khemikhale	kh E m i kh a l E
tlhagisetsang	tlh a x i s E ts> a N
dikgonagalo	d i kx O n a x a l O
monnamogolo	m O n n a m O x O l O
kopantse	k> O p> a n ts> E
dikobo	d i k> O b O
matikiring	m a t> i k> i r i N
nthatile	n th a t> i l E
berebere	b E r E b E r E
bulelwa	b u l E l w a
kgotlatshekelong	kx O tl> a tsh E k> E l O N
tuka	t> u k> a
pholising	ph O l i s i N
marigeng	m a r i x E N
batlang	b a tl> a N
semphato	s E m ph a t> O
atlholwa	a tlh O l w a
thebolo	th E b O l O
dikholomong	d i kh O l O m O N
bagwebi	b a x w E b i
logolo	l O x O l O
selo	s E l O
tlhakantsweng	tlh a k> a n ts> w E N
natla	n a tl> a
bogoregelong	b O x O r E x E l O N
sentlentle	s E n tl> E n tl> E
silega	s i l E x a
gorogela	x O r O x E l a
gauta	x a u t> a
kutu	k> u t> u
kgankgolo	kx a n kx O l O
historing	h i s t> O r i N
ipelafatsang	i p> E l a f a ts> a N
mmetseng	m m E ts> E N
boijane	b O i d0Z a n E
bolaela	b O l a E l a
dikgapheng	d i kx a ph E N
samaganang	s a m a x a n a N
merogo	m E r O x O
hupelwa	h u p> E l w a
theko	th E k> O
dikgololosego	d i kx O l O l O s E x O
tshwanela	tsh w a n E l a
dipiriti	d i p> i r i t> i
butswa	b u ts> w a
boseeng	b O s E E N
phetophetogo	ph E t> O ph E t> O x O
katela	k> a t> E l a
fepa	f E p> a
sebakabakeng	s E b a k> a b a k> E N
fepiwa	f E p> i w a
kgethilwe	kx E th i l w E
ferekanya	f E r E k> a J a
sokasokana	s O k> a s O k> a n a
diphatlhatirong	d i ph a tlh a t> i r O N
maitshetlego	m a i tsh E tl> E x O
pabalesego	p> a b a l E s E x O
mogopolo	m O x O p> O l O
tshamekelang	tsh a m E k> E l a N
boithwalo	b O i th w a l O
welana	w E l a n a
etelang	E t> E l a N
setlamo	s E tl> a m O
tlhotlhiwa	tlh O tlh i w a
iphitlhile	i ph i tlh i l E
tlhokomelong	tlh O k> O m E l O N
bosekisi	b O s E k> i s i
fetisiwa	f E t> i s i w a
semenogane	s E m E n O x a n E
tlosang	tl> O s a N
senolwe	s E n O l w E
baeng	b a E N
tlamelela	tl> a m E l E l a
mosekisi	m O s E k> i s i
tlhalogantse	tlh a l O x a n ts> E
mala	m a l a
dikepe	d i k> E p> E
ditlaleletso	d i tl> a l E l E ts> O
kolobe	k> O l O b E
nthola	n th O l a
tlhotlheletse	tlh O tlh E l E ts> E
kobotlo	k> O b O tl> O
tšhoko	tSh O k> O
morakile	m O r a k> i l E
bothale	b O th a l E
dirileng	d i r i l E N
maitemogelong	m a i t> E m O x E l O N
tagi	t> a x i
lemorago	l E m O r a x O
tsenetse	ts> E n E ts> E
kgonamisitse	kx O n a m i s i ts> E
tsamaong	ts> a m a O N
disaga	d i s a x a
diphate	d i ph a t> E
tlhadilwe	tlh a d i l w E
ntatlhela	n t> a tlh E l a
gobatse	x O b a ts> E
gataka	x a t> a k> a
pogelo	p> O x E l O
dibukatshedimosetsong	d i b u k> a tsh E d i m O s E ts> O N
okobatsa	O k> O b a ts> a
tlhotlhwa	tlh O tlh w a
inšorenseng	i n S O r E n s E N
molekaneng	m O l E k> a n E N
khamera	kh a m E r a
khutsafatso	kh u ts> a f a ts> O
molwantshiwa	m O l w a n tsh i w a
kgothoso	kx O th O s O
logogo	l O x O x O
dikelong	d i k> E l O N
tsenyotirisong	ts> E J O t> i r i s O N
boutela	b O u t> E l a
dirisetse	d i r i s E ts> E
gobaditsweng	x O b a d i ts> w E N
tsena	ts> E n a
dinonnori	d i n O n n O r i
siilweng	s i i l w E N
tlhe	tlh E
anyisa	a J i s a
natso	n a ts> O
moruakgomo	m O r u a kx O m O
ditsibogo	d i ts> i b O x O
phopholegong	ph O ph O l E x O N
lekang	l E k> a N
phologolong	ph O l O x O l O N
folete	f O l E t> E
matswakabele	m a ts> w a k> a b E l E
sebokophetlhi	s E b O k> O ph E tlh i
duelelwang	d u E l E l w a N
tlhaloswa	tlh a l O s w a
lesometharo	l E s O m E th a r O
dikereke	d i k> E r E k> E
seditse	s E d i ts> E
nae	n a E
modiro	m O d i r O
lekanyetse	l E k> a J E ts> E
matona	m a t> O n a
loma	l O m a
nyatsi	J a ts> i
nagatlase	n a x a tl> a s E
gontsi	x O n ts> i
botsolodiwa	b O ts> O l O d i w a
mmolelelang	m m O l E l E l a N
nya	J a
nneng	n n E N
tlhokisitsweng	tlh O k> i s i ts> w E N
nyana	J a n a
itumelela	i t> u m E l E l a
botlhale	b O tlh a l E
ditsweletso	d i ts> w E l E ts> O
atlholelwang	a tlh O l E l w a N
hibila	h i b i l a
lefisiwang	l E f i s i w a N
dikganetsano	d i kx a n E ts> a n O
thulaganyetso	th u l a x a J E ts> O
ileditsweng	i l E d i ts> w E N
tlhaloganyesege	tlh a l O x a J E s E x E
reye	r E j E
mosime	m O s i m E
hupileng	h u p> i l E N
ilediwa	i l E d i w a
maiphitlhelo	m a i ph i tlh E l O
siamiseditswe	s i a m i s E d i ts> w E
kamo	k> a m O
khutlisitsweng	kh u tl> i s i ts> w E N
sutang	s u t> a N
senyeng	s E J E N
boloditseng	b O l O d i ts> E N
rekisa	r E k> i s a
dusa	d u s a
tlhanolola	tlh a n O l O l a
gogele	x O x E l E
balekaneng	b a l E k> a n E N
mmoifang	m m O i f a N
pholo	ph O l O
polasa	p> O l a s a
tlhakakgolo	tlh a k> a kx O l O
basekaseki	b a s E k> a s E k> i
mosele	m O s E l E
romelweng	r O m E l w E N
boithuti	b O i th u t> i
peto	p> E t> O
ikamanyang	i k> a m a J a N
newa	n E w a
tlhotse	tlh O ts> E
mofuta	m O f u t> a
babalesegang	b a b a l E s E x a N
tshwano	tsh w a n O
namana	n a m a n a
dirisane	d i r i s a n E
tlwaetseng	tl> w a E ts> E N
šema	S E m a
lemogiwa	l E m O x i w a
totobaditse	t> O t> O b a d i ts> E
rantang	r a n t> a N
itshireletsa	i tsh i r E l E ts> a
bomorwadie	b O m O r w a d i E
gatisitse	x a t> i s i ts> E
baimana	b a i m a n a
iphitlhela	i ph i tlh E l a
satelaete	s a t> E l a E t> E
gagaselang	x a x a s E l a N
ditlhodi	d i tlh O d i
dikgele	d i kx E l E
diragetse	d i r a x E ts> E
ditikwatikwe	d i t> i k> w a t> i k> w E
fusetsa	f u s E ts> a
adilwe	a d i l w E
ditlankana	d i tl> a n k> a n a
lekhubu	l E kh u b u
bokae	b O k> a E
sebokosegi	s E b O k> O s E x i
fisegela	f i s E x E l a
dikhanakhana	d i kh a n a kh a n a
diretse	d i r E ts> E
bantsho	b a n tsh O
elela	E l E l a
koketsegong	k> O k> E ts> E x O N
fisitsweng	f i s i ts> w E N
madisong	m a d i s O N
masea	m a s E a
boakaretsi	b O a k> a r E ts> i
sireletsang	s i r E l E ts> a N
tlhomiwa	tlh O m i w a
nametshego	n a m E tsh E x O
itumedisitswe	i t> u m E d i s i ts> w E
tlhaoleng	tlh a O l E N
ditselana	d i ts> E l a n a
siame	s i a m E
tlhokomelesegile	tlh O k> O m E l E s E x i l E
diragaletseng	d i r a x a l E ts> E N
ipiletsa	i p> i l E ts> a
ditikwatikweng	d i t> i k> w a t> i k> w E N
leleditse	l E l E d i ts> E
ngokela	N O k> E l a
merwalonyana	m E r w a l O J a n a
nnaya	n n a j a
diterebe	d i t> E r E b E
mogolo	m O x O l O
ikageng	i k> a x E N
lejwa	l E d0Z w a
lebile	l E b i l E
somoga	s O m O x a
motseneledi	m O ts> E n E l E d i
maepa	m a E p> a
ditshikare	d i tsh i k> a r E
duelwe	d u E l w E
dutle	d u tl> E
khumo	kh u m O
tlotlwa	tl> O tl> w a
megatla	m E x a tl> a
tsitsibana	ts> i ts> i b a n a
morwadiaka	m O r w a d i a k> a
agega	a x E x a
dirutweng	d i r u t> w E N
kgakola	kx a k> O l a
khampase	kh a m p> a s E
kagonyana	k> a x O J a n a
kabakantsweng	k> a b a k> a n ts> w E N
sekganela	s E kx a n E l a
dithaka	d i th a k> a
sebitlo	s E b i tl> O
bogodi	b O x O d i
dikgonego	d i kx O n E x O
kgadikanya	kx a d i k> a J a
mogodisi	m O x O d i s i
dituelo	d i t> u E l O
bofetoledi	b O f E t> O l E d i
manane	m a n a n E
bokaelo	b O k> a E l O
latswiwang	l a ts> w i w a N
tagilwe	t> a x i l w E
methapo	m E th a p> O
mofatlhosi	m O f a tlh O s i
ikhutse	i kh u ts> E
phetogo	ph E t> O x O
dikgwetlho	d i kx w E tlh O
ditshingwaneng	d i tsh i N w a n E N
sekoloto	s E k> O l O t> O
ngategile	N a t> E x i l E
humanegile	h u m a n E x i l E
ntshediwa	n tsh E d i w a
tshepega	tsh E p> E x a
purapura	p> u r a p> u r a
lengothe	l E N O th E
seporeng	s E p> O r E N
sematla	s E m a tl> a
ponto	p> O n t> O
ribolotswe	r i b O l O ts> w E
bogato	b O x a t> O
tlhodile	tlh O d i l E
boipuso	b O i p> u s O
tshameka	tsh a m E k> a
thibane	th i b a n E
kgwedi	kx w E d i
tsosoloso	ts> O s O l O s O
modikong	m O d i k> O N
laesense	l a E s E n s E
sunya	s u J a
bokgola	b O kx O l a
tlhakatlhakaneng	tlh a k> a tlh a k> a n E N
ditlhagiswa	d i tlh a x i s w a
aterese	a t> E r E s E
fitlheng	f i tlh E N
malome	m a l O m E
maungong	m a u N O N
botabutabu	b O t> a b u t> a b u
matsutsuba	m a ts> u ts> u b a
batsading	b a ts> a d i N
tlhanola	tlh a n O l a
kokotwa	k> O k> O t> w a
metlhape	m E tlh a p> E
alafela	a l a f E l a
robaletse	r O b a l E ts> E
atlhotswe	a tlh O ts> w E
rorela	r O r E l a
leungo	l E u N O
thubiwa	th u b i w a
kakanyokakaretso	k> a k> a J O k> a k> a r E ts> O
logelang	l O x E l a N
tsweletsweng	ts> w E l E ts> w E N
jalwe	d0Z a l w E
felelediwa	f E l E l E d i w a
phimole	ph i m O l E
lebogo	l E b O x O
lebelele	l E b E l E l E
peita	p> E i t> a
motekwane	m O t> E k> w a n E
kgaogano	kx a O x a n O
amogelege	a m O x E l E x E
pitlagane	p> i tl> a x a n E
ripitlang	r i p> i tl> a N
bata	b a t> a
builweng	b u i l w E N
gokelele	x O k> E l E l E
nngoba	n N O b a
bagatising	b a x a t> i s i N
batshabi	b a tsh a b i
nyalano	J a l a n O
popegopuo	p> O p> E x O p> u O
teseke	t> E s E k> E
itlhophelwa	i tlh O ph E l w a
nene	n E n E
itlhatlhobe	i tlh a tlh O b E
dinaweng	d i n a w E N
dikantoro	d i k> a n t> O r O
bontsha	b O n tsh a
mabotlolo	m a b O tl> O l O
tlholwe	tlh O l w E
motlakase	m O tl> a k> a s E
senyegile	s E J E x i l E
disekele	d i s E k> E l E
laolelwang	l a O l E l w a N
sejaneng	s E d0Z a n E N
lebagane	l E b a x a n E
itshotse	i tsh O ts> E
mafureng	m a f u r E N
maitlhomo	m a i tlh O m O
belegetswe	b E l E x E ts> w E
peelomabaka	p> E E l O m a b a k> a
feletseng	f E l E ts> E N
dirwe	d i r w E
ditumalano	d i t> u m a l a n O
dingwagakgolong	d i N w a x a kx O l O N
poti	p> O t> i
boitekanelong	b O i t> E k> a n E l O N
okameng	O k> a m E N
nthapela	n th a p> E l a
alafilweng	a l a f i l w E N
pitsana	p> i ts> a n a
lelemetsa	l E l E m E ts> a
dikopanyi	d i k> O p> a J i
fenngwa	f E n N w a
bapatsa	b a p> a ts> a
inama	i n a m a
paputla	p> a p> u tl> a
mene	m E n E
mebileng	m E b i l E N
tsididi	ts> i d i d i
nopola	n O p> O l a
ikemiseditse	i k> E m i s E d i ts> E
ntletsentletse	n tl> E ts> E n tl> E ts> E
kanala	k> a n a l a
sianisitse	s i a n i s i ts> E
mebele	m E b E l E
duma	d u m a
monyelwang	m O J E l w a N
lele	l E l E
mathaka	m a th a k> a
ile	i l E
abang	a b a N
tsayang	ts> a j a N
latelwe	l a t> E l w E
gagamalela	x a x a m a l E l a
boyone	b O j O n E
dikwadiso	d i k> w a d i s O
karoganyo	k> a r O x a J O
pela	p> E l a
maatla	m a tl> a
molora	m O l O r a
tshepiwang	tsh E p> i w a N
raditoro	r a d i t> O r O
bobokong	b O b O k> O N
serobi	s E r O b i
itshimololela	i tsh i m O l O l E l a
botshepeging	b O tsh E p> E x i N
moragonyana	m O r a x O J a n a
gogolegang	x O x O l E x a N
golaganngwe	x O l a x a n N w E
setopong	s E t> O p> O N
phokelelo	ph O k> E l E l O
thutegong	th u t> E x O N
direlwe	d i r E l w E
sekasekang	s E k> a s E k> a N
mesima	m E s i m a
borukutlhi	b O r u k> u tlh i
iphaposa	i ph a p> O s a
sentsweng	s E n ts> w E N
buisegang	b u i s E x a N
ruilweng	r u i l w E N
leseding	l E s E d i N
mmawena	m m a w E n a
setshwano	s E tsh w a n O
tsamaelang	ts> a m a E l a N
latlhega	l a tlh E x a
pharologanong	ph a r O l O x a n O N
imile	i m i l E
mabeleng	m a b E l E N
kgaoganngwa	kx a O x a n N w a
khonferense	kh O n f E r E n s E
tlholang	tlh O l a N
okeditswe	O k> E d i ts> w E
ditona	d i t> O n a
kgatlhisitseng	kx a tlh i s i ts> E N
dithoro	d i th O r O
kgaoganya	kx a O x a J a
falosa	f a l O s a
rekiseditswe	r E k> i s E d i ts> w E
tlhotlhwatlase	tlh O tlh w a tl> a s E
bangongoregi	b a N O N O r E x i
benyabenyang	b E J a b E J a N
maabane	m a b a n E
tshikinyega	tsh i k> i J E x a
tlwaelegang	tl> w a E l E x a N
ikopanya	i k> O p> a J a
peeletsong	p> E E l E ts> O N
outse	O u ts> E
siamise	s i a m i s E
kgannyaneng	kx a n J a n E N
bokwaleding	b O k> w a l E d i N
opisa	O p> i s a
kgotlagano	kx O tl> a x a n O
lepelela	l E p> E l E l a
gapileng	x a p> i l E N
mhago	m h a x O
betleng	b E tl> E N
fetofetoga	f E t> O f E t> O x a
itira	i t> i r a
tshuma	tsh u m a
melatswana	m E l a ts> w a n a
kannwe	k> a n n w E
fitlhetsweng	f i tlh E ts> w E N
dipapatso	d i p> a p> a ts> O
mangenana	m a N E n a n a
mateng	m a t> E N
kopanyang	k> O p> a J a N
mmelegi	m m E l E x i
dilaeborari	d i l a E b O r a r i
motšhineng	m O tSh i n E N
tliseng	tl> i s E N
basari	b a s a r i
moteteselong	m O t> E t> E s E l O N
eteletsweng	E t> E l E ts> w E N
rebolele	r E b O l E l E
gatilwe	x a t> i l w E
tlhotlhomisa	tlh O tlh O m i s a
modirising	m O d i r i s i N
mafatlha	m a f a tlh a
tlalelana	tl> a l E l a n a
tlhotlhwagodimo	tlh O tlh w a x O d i m O
gapelediwang	x a p> E l E d i w a N
nwang	n w a N
goa	x O a
kgotsofadiwa	kx O ts> O f a d i w a
kereiting	k> E r E i t> i N
rekwa	r E k> w a
tlamelana	tl> a m E l a n a
seterateng	s E t> E r a t> E N
gatlharisa	x a tlh a r i s a
kageletso	k> a x E l E ts> O
ditlhogwana	d i tlh O x w a n a
pha	ph a
digang	d i x a N
fisiwe	f i s i w E
phediso	ph E d i s O
kokoanopeomolao	k> O k> O a n O p> E O m O l a O
mebereko	m E b E r E k> O
neeletsanong	n E E l E ts> a n O N
letseka	l E ts> E k> a
tirisanommogo	t> i r i s a n O m m O x O
letsapanyana	l E ts> a p> a J a n a
ntlafatsa	n tl> a f a ts> a
iponele	i p> O n E l E
phudiso	ph u d i s O
dueleng	d u E l E N
ditlhagelelo	d i tlh a x E l E l O
ratswale	r a ts> w a l E
kgolego	kx O l E x O
tlhotlhomisiwa	tlh O tlh O m i s i w a
tebanyo	t> E b a J O
bonkgonne	b O n kx O n n E
thapileng	th a p> i l E N
totobetseng	t> O t> O b E ts> E N
letshwaopotso	l E tsh w a O p> O ts> O
nyeleditsweng	J E l E d i ts> w E N
konosetseng	k> O n O s E ts> E N
rumisanang	r u m i s a n a N
sekwalwa	s E k> w a l w a
phenšene	ph E n S E n E
lekanyetsang	l E k> a J E ts> a N
eng	E N
tshegeditse	tsh E x E d i ts> E
mekgwa	m E kx w a
tshoganyediwa	tsh O x a J E d i w a
tlhabolotse	tlh a b O l O ts> E
kolotwang	k> O l O t> w a N
kwalololo	k> w a l O l O l O
tlhoko	tlh O k> O
phala	ph a l a
peelo	p> E E l O
loruo	l O r u O
kgaogo	kx a O x O
megagaru	m E x a x a r u
rolara	r O l a r a
tsale	ts> a l E
mosakong	m O s a k> O N
lwantsha	l w a n tsh a
latlhelwa	l a tlh E l w a
dubakana	d u b a k> a n a
tlamelong	tl> a m E l O N
mathompong	m a th O m p> O N
phatlaletseng	ph a tl> a l E ts> E N
phitlho	ph i tlh O
pataganya	p> a t> a x a J a
kgagamalo	kx a x a m a l O
ipaakanya	i p> a k> a J a
tsweletsong	ts> w E l E ts> O N
kaba	k> a b a
kgetha	kx E th a
boganana	b O x a n a n a
ditshupo	d i tsh u p> O
matlhotlhapelo	m a tlh O tlh a p> E l O
diposo	d i p> O s O
lotha	l O th a
tlhotlhwakgolo	tlh O tlh w a kx O l O
dithulelo	d i th u l E l O
pegilweng	p> E x i l w E N
duelelwa	d u E l E l w a
agelela	a x E l E l a
bobaba	b O b a b a
metsemagae	m E ts> E m a x a E
itshunya	i tsh u J a
khibidu	kh i b i d u
kemisong	k> E m i s O N
mosamarea	m O s a m a r E a
tlhatlhamologa	tlh a tlh a m O l O x a
dimelametsing	d i m E l a m E ts> i N
mokgeleng	m O kx E l E N
tlhobolo	tlh O b O l O
phetolelo	ph E t> O l E l O
bente	b E n t> E
feleletse	f E l E l E ts> E
logaganngwa	l O x a x a n N w a
bontlhanngwe	b O n tlh a n N w E
tlelapa	tl> E l a p> a
tswe	ts> w E
lemela	l E m E l a
mmotsa	m m O ts> a
bomaitseanape	b O m a i ts> E a n a p> E
mesong	m E s O N
batshegetsi	b a tsh E x E ts> i
lebenkeleng	l E b E n k> E l E N
tshega	tsh E x a
kgale	kx a l E
rekisetsa	r E k> i s E ts> a
gaisanang	x a i s a n a N
meteme	m E t> E m E
itirang	i t> i r a N
metswedi	m E ts> w E d i
amanngwang	a m a n N w a N
gakaletse	x a k> a l E ts> E
mothaleng	m O th a l E N
mosifa	m O s i f a
nolofaletsa	n O l O f a l E ts> a
diponagalong	d i p> O n a x a l O N
mosimane	m O s i m a n E
jalelelo	d0Z a l E l E l O
lesilo	l E s i l O
dijotshegare	d i d0Z O tsh E x a r E
sekega	s E k> E x a
botsotsi	b O ts> O ts> i
iteileng	i t> E i l E N
motsaneng	m O ts> a n E N
itlamileng	i tl> a m i l E N
balola	b a l O l a
kagisano	k> a x i s a n O
diraka	d i r a k> a
segiwang	s E x i w a N
kgonojwe	kx O n O d0Z w E
dirwa	d i r w a
kgaola	kx a O l a
kaelwe	k> a E l w E
mothati	m O th a t> i
itisitse	i t> i s i ts> E
thapameng	th a p> a m E N
leruonyana	l E r u O J a n a
lekiwa	l E k> i w a
itsisiwa	i ts> i s i w a
maleme	m a l E m E
dikalana	d i k> a l a n a
tlhotswe	tlh O ts> w E
tsamaisiwang	ts> a m a i s i w a N
kaiwang	k> a i w a N
etsi	E ts> i
okama	O k> a m a
santlhoko	s a n tlh O k> O
silwa	s i l w a
neelane	n E E l a n E
gana	x a n a
monnasetilo	m O n n a s E t> i l O
tlhomaganyo	tlh O m a x a J O
bonetetshing	b O n E t> E tsh i N
kwadisitsweng	k> w a d i s i ts> w E N
intasetering	i n t> a s E t> E r i N
tlhaping	tlh a p> i N
tshuba	tsh u b a
tlhatlosiwa	tlh a tl> O s i w a
boloke	b O l O k> E
maotwana	m a O t> w a n a
letšhotlho	l E tSh O tlh O
diintasetering	d i i n t> a s E t> E r i N
refosanela	r E f O s a n E l a
sesole	s E s O l E
tshireletsong	tsh i r E l E ts> O N
itsetsepela	i ts> E ts> E p> E l a
teteselang	t> E t> E s E l a N
tshekamelong	tsh E k> a m E l O N
lekole	l E k> O l E
maphateng	m a ph a t> E N
tlhalosiwa	tlh a l O s i w a
sasanka	s a s a n k> a
teko	t> E k> O
dikgamu	d i kx a m u
itsholetseng	i tsh O l E ts> E N
ikgopotse	i kx O p> O ts> E
lebadi	l E b a d i
mosamo	m O s a m O
botsereganyi	b O ts> E r E x a J i
kaiwe	k> a i w E
dia	d i a
diragadibonwe	d i r a x a d i b O n w E
kopantshiwa	k> O p> a n tsh i w a
kaelwa	k> a E l w a
mabogong	m a b O x O N
kwelotlaseng	k> w E l O tl> a s E N
tsamaye	ts> a m a j E
ntirile	n t> i r i l E
pompelang	p> O m p> E l a N
tshelong	tsh E l O N
mokgweleo	m O kx w E l E O
ijesa	i d0Z E s a
khutlisiwa	kh u tl> i s i w a
godisitseng	x O d i s i ts> E N
tenego	t> E n E x O
dutla	d u tl> a
dithapelo	d i th a p> E l O
gaisane	x a i s a n E
lemogile	l E m O x i l E
kopisa	k> O p> i s a
ketefatsa	k> E t> E f a ts> a
rra	r r a
kobelo	k> O b E l O
elelele	E l E l E l E
elelwa	E l E l w a
bokomisinara	b O k> O m i s i n a r a
rutega	r u t> E x a
sekgopi	s E kx O p> i
utlwisa	u tl> w i s a
ena	E n a
tshenyong	tsh E J O N
boitseanape	b O i ts> E a n a p> E
okosijene	O k> O s i d0Z E n E
mengwe	m E N w E
sedupe	s E d u p> E
ngongorego	N O N O r E x O
tselegantsweng	ts> E l E x a n ts> w E N
boreelelong	b O r E E l E l O N
setlheng	s E tlh E N
neilweng	n E i l w E N
leofela	l E O f E l a
matlhatshana	m a tlh a tsh a n a
ikgomotseng	i kx O m O ts> E N
tlhomilweng	tlh O m i l w E N
galefetse	x a l E f E ts> E
iphetsa	i ph E ts> a
kwelotlase	k> w E l O tl> a s E
leofetse	l E O f E ts> E
dingwagangwaga	d i N w a x a N w a x a
sebalamakgolo	s E b a l a m a kx O l O
lokologile	l O k> O l O x i l E
bojotlhe	b O d0Z O tlh E
babelegi	b a b E l E x i
fapositswe	f a p> O s i ts> w E
tshouto	tsh O u t> O
busediwa	b u s E d i w a
karatšhe	k> a r a tSh E
pegelong	p> E x E l O N
tlatse	tl> a ts> E
lokwalodikgang	l O k> w a l O d i kx a N
tsetlela	ts> E tl> E l a
babalela	b a b a l E l a
pampiri	p> a m p> i r i
gonyetsa	x O J E ts> a
photha	ph O th a
tshubiwa	tsh u b i w a
letlhatso	l E tlh a ts> O
dikano	d i k> a n O
kokoanela	k> O k> O a n E l a
itsalanya	i ts> a l a J a
kwadisong	k> w a d i s O N
metlae	m E tl> a E
thuntshiwa	th u n tsh i w a
renang	r E n a N
mekgabo	m E kx a b O
mmuledisa	m m u l E d i s a
phatlalatseng	ph a tl> a l a ts> E N
katoge	k> a t> O x E
sekaong	s E k> a O N
itisa	i t> i s a
khutshwane	kh u tsh w a n E
tiragalo	t> i r a x a l O
amogelesegile	a m O x E l E s E x i l E
gotetse	x O t> E ts> E
lephodisa	l E ph O d i s a
ntlo	n tl> O
ditementsi	d i t> E m E n ts> i
ititeile	i t> i t> E i l E
logora	l O x O r a
basegi	b a s E x i
meropa	m E r O p> a
duedisang	d u E d i s a N
tlhaologile	tlh a O l O x i l E
sephiring	s E ph i r i N
poraefeteng	p> O r a E f E t> E N
nkatle	n k> a tl> E
dipotsolotsano	d i p> O ts> O l O ts> a n O
relelang	r E l E l a N
tlhololo	tlh O l O l O
botlhofonyana	b O tlh O f O J a n a
ditediamo	d i t> E d i a m O
godingwana	x O d i N w a n a
paledisang	p> a l E d i s a N
tlhakantsha	tlh a k> a n tsh a
matipane	m a t> i p> a n E
diela	d i E l a
tswee	ts> w E E
repileng	r E p> i l E N
setu	s E t> u
ikgantsha	i kx a n tsh a
apare	a p> a r E
fokotsang	f O k> O ts> a N
mawatleng	m a w a tl> E N
rekisetsang	r E k> i s E ts> a N
nkopa	n k> O p> a
tlhomaganang	tlh O m a x a n a N
gopane	x O p> a n E
tshwaetsa	tsh w a E ts> a
dikgobe	d i kx O b E
apere	a p> E r E
tsenweng	ts> E n w E N
bobebe	b O b E b E
kgogometso	kx O x O m E ts> O
lebisiwang	l E b i s i w a N
bonale	b O n a l E
kgabetsakgabetsa	kx a b E ts> a kx a b E ts> a
sekaelo	s E k> a E l O
matsha	m a tsh a
katisiwang	k> a t> i s i w a N
thekokhiro	th E k> O kh i r O
okametse	O k> a m E ts> E
rekisiwang	r E k> i s i w a N
kgweediwe	kx w E E d i w E
tlhokelwa	tlh O k> E l w a
bakgweetsing	b a kx w E E ts> i N
kelotefo	k> E l O t> E f O
tlhaloseditse	tlh a l O s E d i ts> E
tsalo	ts> a l O
kadiwa	k> a d i w a
temokerasi	t> E m O k> E r a s i
gokelela	x O k> E l E l a
mmugodimo	m m u x O d i m O
bulang	b u l a N
dibareng	d i b a r E N
pepetletso	p> E p> E tl> E ts> O
itshwarise	i tsh w a r i s E
botsofe	b O ts> O f E
melato	m E l a t> O
kwadisiweng	k> w a d i s i w E N
tesekeng	t> E s E k> E N
utlwele	u tl> w E l E
bontshitseng	b O n tsh i ts> E N
mokhanselara	m O kh a n s E l a r a
matlhole	m a tlh O l E
latswa	l a ts> w a
diegisiwa	d i E x i s i w a
tsamaisang	ts> a m a i s a N
mojeng	m O d0Z E N
phorosela	ph O r O s E l a
lwana	l w a n a
thokolo	th O k> O l O
ditlhabololo	d i tlh a b O l O l O
dikota	d i k> O t> a
momaganya	m O m a x a J a
lotlhakore	l O tlh a k> O r E
tikologong	t> i k> O l O x O N
thelebišeneng	th E l E b i S E n E N
mothaping	m O th a p> i N
omile	O m i l E
phalolong	ph a l O l O N
ipelaele	i p> E l a E l E
maratagolejwa	m a r a t> a x O l E d0Z w a
mosemeng	m O s E m E N
leng	l E N
tlise	tl> i s E
matheng	m a th E N
sisimosang	s i s i m O s a N
tshoga	tsh O x a
tsalwa	ts> a l w a
kamano	k> a m a n O
rena	r E n a
