beile	b E i l E
kano	k> a n O
dikgaolong	d i kx a O l O N
itlhagise	i tlh a x i s E
phatlaladiwa	ph a tl> a l a d i w a
rutlega	r u tl> E x a
diatleletiking	d i a tl> E l E t> i k> i N
feela	f E E l a
duedisiwa	d u E d i s i w a
tlhatlhelo	tlh a tlh E l O
kganetsanong	kx a n E ts> a n O N
kateleng	k> a t> E l E N
rulaganngwang	r u l a x a n N w a N
tlhoboganong	tlh O b O x a n O N
peterolong	p> E t> E r O l O N
mosamong	m O s a m O N
sekwalo	s E k> w a l O
moretologa	m O r E t> O l O x a
godise	x O d i s E
thefosanyo	th E f O s a J O
kgabaganya	kx a b a x a J a
pakeng	p> a k> E N
elelang	E l E l a N
malwetsenyana	m a l w E ts> E J a n a
batlhokwa	b a tlh O k> w a
halofo	h a l O f O
dipotefolio	d i p> O t> E f O l i O
aka	a k> a
tlhalefa	tlh a l E f a
belaele	b E l a E l E
robaditse	r O b a d i ts> E
kwelano	k> w E l a n O
modulasetilo	m O d u l a s E t> i l O
opelelwa	O p> E l E l w a
itlhophetseng	i tlh O ph E ts> E N
tshwarelwa	tsh w a r E l w a
tshwantshiso	tsh w a n tsh i s O
gobo	x O b O
thusaneng	th u s a n E N
mpha	m ph a
namatshega	n a m a tsh E x a
ka	k> a
etegetse	E t> E x E ts> E
ntlhabela	n tlh a b E l a
botlhankedi	b O tlh a n k> E d i
dikwalwa	d i k> w a l w a
magang	m a x a N
tlhatlogile	tlh a tl> O x i l E
kuku	k> u k> u
tlotlanong	tl> O tl> a n O N
gakiwa	x a k> i w a
ntseele	n ts> E E l E
tadi	t> a d i
tshasitswe	tsh a s i ts> w E
lebanang	l E b a n a N
dikgolagano	d i kx O l a x a n O
rulaganngwa	r u l a x a n N w a
tlhatlositse	tlh a tl> O s i ts> E
tlhatlhobile	tlh a tlh O b i l E
somarelang	s O m a r E l a N
taolong	t> a O l O N
mokeresete	m O k> E r E s E t> E
polase	p> O l a s E
mangwe	m a N w E
tlhonama	tlh O n a m a
abileng	a b i l E N
bopele	b O p> E l E
phefo	ph E f O
tlhabololwe	tlh a b O l O l w E
dilekanyetsong	d i l E k> a J E ts> O N
senoge	s E n O x E
nnaka	n n a k> a
moše	m O S E
tswelediseng	ts> w E l E d i s E N
khutsana	kh u ts> a n a
tlhokileng	tlh O k> i l E N
setšhabeng	s E tSh a b E N
golaganngwang	x O l a x a n N w a N
tlamega	tl> a m E x a
gokaganye	x O k> a x a J E
fapaana	f a p> a n a
beileng	b E i l E N
ngotlega	N O tl> E x a
kgobokantswe	kx O b O k> a n ts> w E
tlanya	tl> a J a
seithati	s E i th a t> i
robile	r O b i l E
thibelela	th i b E l E l a
porofensi	p> O r O f E n s i
raelwa	r a E l w a
tomagano	t> O m a x a n O
kgwebisanong	kx w E b i s a n O N
tolwe	t> O l w E
tumanosi	t> u m a n O s i
dirisana	d i r i s a n a
kaelwang	k> a E l w a N
bothato	b O th a t> O
fetisetswang	f E t> i s E ts> w a N
tlhodie	tlh O d i E
bodutiso	b O d u t> i s O
kemeding	k> E m E d i N
gogwa	x O x w a
rapela	r a p> E l a
itshupileng	i tsh u p> i l E N
kgobokano	kx O b O k> a n O
terasete	t> E r a s E t> E
tsamaele	ts> a m a E l E
tagwa	t> a x w a
tlelaemete	tl> E l a E m E t> E
ikgapela	i kx a p> E l a
etleetsa	E tl> E E ts> a
tshologa	tsh O l O x a
marama	m a r a m a
matsenong	m a ts> E n O N
abelela	a b E l E l a
kona	k> O n a
tlhokelwang	tlh O k> E l w a N
ditšhaba	d i tSh a b a
hemisefere	h E m i s E f E r E
ditemalo	d i t> E m a l O
pagolola	p> a x O l O l a
gadikilweng	x a d i k> i l w E N
khomphutara	kh O m ph u t> a r a
seabe	s E a b E
dikotaseng	d i k> O t> a s E N
masaka	m a s a k> a
lekwalokaong	l E k> w a l O k> a O N
bonyana	b O J a n a
meroba	m E r O b a
weditswe	w E d i ts> w E
senyaka	s E J a k> a
ikaelelang	i k> a E l E l a N
tswelelela	ts> w E l E l E l a
tlhaolwa	tlh a O l w a
dikai	d i k> a i
tshwaetsegong	tsh w a E ts> E x O N
maitato	m a i t> a t> O
pherekano	ph E r E k> a n O
bolokesega	b O l O k> E s E x a
methamo	m E th a m O
phepa	ph E p> a
ntšhwa	n tSh w a
dikgaisanong	d i kx a i s a n O N
bopama	b O p> a m a
arolwa	a r O l w a
kgobang	kx O b a N
abelanwa	a b E l a n w a
digopo	d i x O p> O
mogadibo	m O x a d i b O
kagong	k> a x O N
farolola	f a r O l O l a
dijalo	d i d0Z a l O
kukama	k> u k> a m a
mmegela	m m E x E l a
thateng	th a t> E N
sotla	s O tl> a
ntlha	n tlh a
ganeng	x a n E N
matlase	m a tl> a s E
kokoanyo	k> O k> O a J O
tatofatso	t> a t> O f a ts> O
mangweng	m a N w E N
kgotlakgolo	kx O tl> a kx O l O
motlhankeding	m O tlh a n k> E d i N
polotiking	p> O l O t> i k> i N
barutegi	b a r u t> E x i
diponelopele	d i p> O n E l O p> E l E
maikwatlhao	m a i k> w a tlh a O
fokolang	f O k> O l a N
rarabolotse	r a r a b O l O ts> E
dumelanweng	d u m E l a n w E N
itshiela	i tsh i E l a
fetoleng	f E t> O l E N
kopelo	k> O p> E l O
direlang	d i r E l a N
leofile	l E O f i l E
bepa	b E p> a
bakega	b a k> E x a
rakgwebo	r a kx w E b O
legong	l E x O N
sephatlo	s E ph a tl> O
batlana	b a tl> a n a
modikologa	m O d i k> O l O x a
bolosika	b O l O s i k> a
phimotsweng	ph i m O ts> w E N
busiwa	b u s i w a
baakanye	b a k> a J E
saleng	s a l E N
tiiseng	t> i i s E N
lebatsa	l E b a ts> a
karo	k> a r O
fiwe	f i w E
segolosetonna	s E x O l O s E t> O n n a
kgaolwa	kx a O l w a
tsamae	ts> a m a E
netefaditsweng	n E t> E f a d i ts> w E N
pharologanyo	ph a r O l O x a J O
bese	b E s E
ntsholela	n tsh O l E l a
ntebile	n t> E b i l E
mogogi	m O x O x i
moroko	m O r O k> O
atamelaneng	a t> a m E l a n E N
gorosiwa	x O r O s i w a
mmakgonthe	m m a kx O n th E
netefatsong	n E t> E f a ts> O N
matshwaong	m a tsh w a O N
itshidilola	i tsh i d i l O l a
dipusong	d i p> u s O N
dinku	d i n k> u
morwalo	m O r w a l O
tshwenyana	tsh w E J a n a
bogodimong	b O x O d i m O N
kumola	k> u m O l a
dirisiwang	d i r i s i w a N
moropa	m O r O p> a
huduga	h u d u x a
monwaneng	m O n w a n E N
setshwao	s E tsh w a O
beetsweng	b E E ts> w E N
matlhaka	m a tlh a k> a
tekanyetso	t> E k> a J E ts> O
bonala	b O n a l a
kuta	k> u t> a
legammana	l E x a m m a n a
dintlha	d i n tlh a
tshwaragantseng	tsh w a r a x a n ts> E N
ntaela	n t> a E l a
tsenya	ts> E J a
letlhale	l E tlh a l E
tlhabologo	tlh a b O l O x O
bosometlhano	b O s O m E tlh a n O
ditomo	d i t> O m O
boro	b O r O
selefatshe	s E l E f a tsh E
melamu	m E l a m u
setatšhe	s E t> a tSh E
anamang	a n a m a N
patagantsweng	p> a t> a x a n ts> w E N
mothopi	m O th O p> i
raraaneng	r a r a n E N
batlela	b a tl> E l a
dikoleke	d i k> O l E k> E
fale	f a l E
maphataphata	m a ph a t> a ph a t> a
nyeletsong	J E l E ts> O N
ageng	a x E N
setlogolwana	s E tl> O x O l w a n a
emelela	E m E l E l a
bathonyana	b a th O J a n a
borukhu	b O r u kh u
boammaaruri	b O a m m a r u r i
dikoloto	d i k> O l O t> O
batlisisitsweng	b a tl> i s i s i ts> w E N
bolelang	b O l E l a N
ditlhaelo	d i tlh a E l O
tshwaro	tsh w a r O
lesira	l E s i r a
tlhaelo	tlh a E l O
ngokwa	N O k> w a
tsee	ts> E E
pholong	ph O l O N
ditoropo	d i t> O r O p> O
setsidifatsi	s E ts> i d i f a ts> i
mmabontle	m m a b O n tl> E
fetisetse	f E t> i s E ts> E
lesoba	l E s O b a
melaetseng	m E l a E ts> E N
segalo	s E x a l O
swaa	s w a
khutliso	kh u tl> i s O
ditshutiso	d i tsh u t> i s O
polelwaneng	p> O l E l w a n E N
mofu	m O f u
lepalepana	l E p> a l E p> a n a
diminerale	d i m i n E r a l E
tlhotlhweng	tlh O tlh w E N
bontshitse	b O n tsh i ts> E
itsitse	i ts> i ts> E
phepafadiwa	ph E p> a f a d i w a
khutlopono	kh u tl> O p> O n O
itirelang	i t> i r E l a N
gogang	x O x a N
talelo	t> a l E l O
aroganye	a r O x a J E
ntshwafatswa	n tsh w a f a ts> w a
ngaparela	N a p> a r E l a
kgaolelwa	kx a O l E l w a
mapai	m a p> a i
borogo	b O r O x O
ntshegetsa	n tsh E x E ts> a
diteleko	d i t> l E k> O
siamela	s i a m E l a
utswilwe	u ts> w i l w E
fetlhang	f E tlh a N
gammogo	x a m m O x O
palokgolo	p> a l O kx O l O
letlhomeso	l E tlh O m E s O
omisiwa	O m i s i w a
siametse	s i a m E ts> E
khurumeditsweng	kh u r u m E d i ts> w E N
ledi	l E d i
moelatlhoko	m O E l a tlh O k> O
itsalantse	i ts> a l a n ts> E
pholesing	ph O l E s i N
makuku	m a k> u k> u
morula	m O r u l a
tlhoba	tlh O b a
kgatinya	kx a t> i J a
mmaarona	m m a r O n a
malobeng	m a l O b E N
ipaakanyetsa	i p> a k> a J E ts> a
arogantswe	a r O x a n ts> w E
pelwana	p> E l w a n a
bosusu	b O s u s u
tshaso	tsh a s O
maineng	m a i n E N
moswelwa	m O s w E l w a
temekang	t> E m E k> a N
kgakgamalo	kx a kx a m a l O
kolo	k> O l O
mantsi	m a n ts> i
bopiwang	b O p> i w a N
thusegileng	th u s E x i l E N
dinaong	d i n a O N
fetolaka	f E t> O l a k> a
lebagana	l E b a x a n a
rothisa	r O th i s a
intatola	i n t> a t> O l a
tlisiwe	tl> i s i w E
dintha	d i n th a
idibala	i d i b a l a
tshenkelo	tsh E n k> E l O
lekane	l E k> a n E
selekanyi	s E l E k> a J i
nolofetse	n O l O f E ts> E
mokaloba	m O k> a l O b a
dipolantere	d i p> O l a n t> E r E
kganelwa	kx a n E l w a
ngangisana	N a N i s a n a
lobopo	l O b O p> O
tlhamiwa	tlh a m i w a
mefutafuta	m E f u t> a f u t> a
dikhai	d i kh a i
bokgarebe	b O kx a r E b E
kgabola	kx a b O l a
dikapolelo	d i k> a p> O l E l O
adima	a d i m a
kgotlela	kx O tl> E l a
dumella	d u m E l l a
batsereganyi	b a ts> E r E x a J i
saletseng	s a l E ts> E N
letlojana	l E tl> O d0Z a n a
dipharologantsho	d i ph a r O l O x a n tsh O
tsamaeng	ts> a m a E N
boikaelelo	b O i k> a E l E l O
tsoge	ts> O x E
kgathalelwe	kx a th a l E l w E
dihotele	d i h O t> E l E
semanego	s E m a n E x O
sofeng	s O f E N
phokoje	ph O k> O d0Z E
apolele	a p> O l E l E
dikwalo	d i k> w a l O
baoking	b a O k> i N
atlegang	a tl> E x a N
komelelong	k> O m E l E l O N
weditseng	w E d i ts> E N
loroleng	l O r O l E N
nitamang	n i t> a m a N
magatwegatwe	m a x a t> w E x a t> w E
ipoeletsa	i p> O E l E ts> a
tabogela	t> a b O x E l a
dirisang	d i r i s a N
dikhampani	d i kh a m p> a n i
kgokologa	kx O k> O l O x a
mogaeno	m O x a E n O
ikutlwile	i k> u tl> w i l E
semmuso	s E m m u s O
ditumelanong	d i t> u m E l a n O N
mpona	m p> O n a
itsholetse	i tsh O l E ts> E
dikemedi	d i k> E m E d i
tswelediwa	ts> w E l E d i w a
mong	m O N
jegang	d0Z E x a N
mokana	m O k> a n a
matlapana	m a tl> a p> a n a
mpolokeng	m p> O l O k> E N
maphanyego	m a ph a J E x O
dithobong	d i th O b O N
peipi	p> E i p> i
itshola	i tsh O l a
kgotsofatsa	kx O ts> O f a ts> a
rapelela	r a p> E l E l a
ngodiego	N O d i E x O
latlhiweng	l a tlh i w E N
letloa	l E tl> O a
ditennye	d i t> E n J E
boteng	b O t> E N
setilong	s E t> i l O N
itaya	i t> a j a
ake	a k> E
betswe	b E ts> w E
tlhophe	tlh O ph E
seemong	s E E m O N
mešwa	m E S w a
polatefomong	p> O l a t> E f O m O N
direle	d i r E l E
dingatana	d i N a t> a n a
solegelwang	s O l E x E l w a N
tsadisa	ts> a d i s a
motswako	m O ts> w a k> O
mamphorwana	m a m ph O r w a n a
tlhaloganyong	tlh a l O x a J O N
thomelong	th O m E l O N
swang	s w a N
phokoletsong	ph O k> O l E ts> O N
leineng	l E i n E N
kgala	kx a l a
tsholetsa	tsh O l E ts> a
balekane	b a l E k> a n E
batlile	b a tl> i l E
maribe	m a r i b E
tlhokega	tlh O k> E x a
mang	m a N
bogela	b O x E l a
dumisiwa	d u m i s i w a
lebileng	l E b i l E N
botsenong	b O ts> E n O N
baithutedi	b a i th u t> E d i
leboteng	l E b O t> E N
lemosegile	l E m O s E x i l E
leferefere	l E f E r E f E r E
segwere	s E x w E r E
phenyo	ph E J O
bolokega	b O l O k> E x a
manaanethuto	m a n a n E th u t> O
boramatlotlo	b O r a m a tl> O tl> O
itlwaetsa	i tl> w a E ts> a
dikgogola	d i kx O x O l a
matsele	m a ts> E l E
ditsholofelo	d i tsh O l O f E l O
akaretsa	a k> a r E ts> a
fetolelwe	f E t> O l E l w E
bitsakaka	b i ts> a k> a k> a
folosetswa	f O l O s E ts> w a
agela	a x E l a
tshedileng	tsh E d i l E N
kutleng	k> u tl> E N
phatlalatswa	ph a tl> a l a ts> w a
molato	m O l a t> O
tshikeng	tsh i k> E N
bodiragatsi	b O d i r a x a ts> i
nyalelana	J a l E l a n a
khurumela	kh u r u m E l a
botsi	b O ts> i
iketse	i k> E ts> E
badirising	b a d i r i s i N
ikimetsa	i k> i m E ts> a
isetsa	i s E ts> a
botokololo	b O t> O k> O l O l O
kuke	k> u k> E
kgokagano	kx O k> a x a n O
ntshwentse	n tsh w E n ts> E
ditshiamelong	d i tsh i a m E l O N
dipuleng	d i p> u l E N
molamu	m O l a m u
botlhodi	b O tlh O d i
phelelo	ph E l E l O
thulo	th u l O
rotseng	r O ts> E N
balelapa	b a l E l a p> a
bonweng	b O n w E N
ngongoregela	N O N O r E x E l a
sejalo	s E d0Z a l O
maphelong	m a ph E l O N
segwete	s E x w E t> E
lepa	l E p> a
lemogilwe	l E m O x i l w E
seriti	s E r i t> i
tlhaphola	tlh a ph O l a
tlolomolato	tl> O l O m O l a t> O
mmawee	m m a w E E
diregang	d i r E x a N
utswilweng	u ts> w i l w E N
itlhaganediseng	i tlh a x a n E d i s E N
tšhateng	tSh a t> E N
raemang	r a E m a N
seripa	s E r i p> a
mohibidu	m O h i b i d u
kwalelwe	k> w a l E l w E
sengwe	s E N w E
itumeletseng	i t> u m E l E ts> E N
rategeng	r a t> E x E N
bala	b a l a
tlhotlhololang	tlh O tlh O l O l a N
dikhomišeneng	d i kh O m i S E n E N
tlhongweng	tlh O N w E N
mmala	m m a l a
bolaodi	b O l a O d i
hupile	h u p> i l E
boutong	b O u t> O N
ketleetso	k> E tl> E E ts> O
tlhokafetse	tlh O k> a f E ts> E
filwe	f i l w E
phatlalatsa	ph a tl> a l a ts> a
tshwareletse	tsh w a r E l E ts> E
sebare	s E b a r E
tabogele	t> a b O x E l E
khiro	kh i r O
bolekanyo	b O l E k> a J O
saa	s a
tokomaneng	t> O k> O m a n E N
taboge	t> a b O x E
dibateng	d i b a t> E N
tswakaneng	ts> w a k> a n E N
lemogang	l E m O x a N
lera	l E r a
ketefaletsa	k> E t> E f a l E ts> a
kantoro	k> a n t> O r O
rekiwang	r E k> i w a N
tsuntsunyetsa	ts> u n ts> u J E ts> a
kgatlhiseng	kx a tlh i s E N
tshwanelwang	tsh w a n E l w a N
babusakgotla	b a b u s a kx O tl> a
boemong	b O E m O N
direla	d i r E l a
lebegang	l E b E x a N
mogodung	m O x O d u N
digwapa	d i x w a p> a
barukhutlhi	b a r u kh u tlh i
rraabonamogolo	r r a b O n a m O x O l O
tsepamong	ts> E p> a m O N
baranodi	b a r a n O d i
botlapa	b O tl> a p> a
marothodinyana	m a r O th O d i J a n a
porofensing	p> O r O f E n s i N
ratane	r a t> a n E
metsotsong	m E ts> O ts> O N
itlhaganedisa	i tlh a x a n E d i s a
molwetseng	m O l w E ts> E N
khupelo	kh u p> E l O
mpolaele	m p> O l a E l E
thuse	th u s E
malapeng	m a l a p> E N
kgoreletsong	kx O r E l E ts> O N
asebesetose	a s E b E s E t> O s E
atlenegisiwang	a tl> E n E x i s i w a N
emisetsang	E m i s E ts> a N
thuanyo	th u a J O
meraba	m E r a b a
ntsheditswe	n tsh E d i ts> w E
mmolelele	m m O l E l E l E
itlhaganedise	i tlh a x a n E d i s E
tumelano	t> u m E l a n O
rwelwe	r w E l w E
tleloko	tl> E l O k> O
swabisang	s w a b i s a N
naya	n a j a
kholera	kh O l E r a
utlwa	u tl> w a
lekanang	l E k> a n a N
makaelagongwe	m a k> a E l a x O N w E
dikgotlhang	d i kx O tlh a N
setilwe	s E t> i l w E
tokafale	t> O k> a f a l E
khutshwanyane	kh u tsh w a J a n E
boikgantsho	b O i kx a n tsh O
batlhabolodi	b a tlh a b O l O d i
sefikantswe	s E f i k> a n ts> w E
dinnete	d i n n E t> E
somarela	s O m a r E l a
katlego	k> a tl> E x O
diyuniti	d i j u n i t> i
rulaganyetsang	r u l a x a J E ts> a N
sekgamu	s E kx a m u
ditlhalosong	d i tlh a l O s O N
sekasekelwa	s E k> a s E k> E l w a
ditaletso	d i t> a l E ts> O
kagegong	k> a x E x O N
tsepamo	ts> E p> a m O
anya	a J a
momagano	m O m a x a n O
senyediwa	s E J E d i w a
kaelweng	k> a E l w E N
letlole	l E tl> O l E
motomong	m O t> O m O N
bokopanelo	b O k> O p> a n E l O
tlhagisitse	tlh a x i s i ts> E
tlhopheng	tlh O ph E N
letsibogo	l E ts> i b O x O
bolokwang	b O l O k> w a N
dumisa	d u m i s a
senngwa	s E n N w a
sebete	s E b E t> E
bapileng	b a p> i l E N
dipakaanyo	d i p> a k> a J O
meditswe	m E d i ts> w E
sentšhwa	s E n tSh w a
digarawe	d i x a r a w E
mahube	m a h u b E
gagogileng	x a x O x i l E N
boifang	b O i f a N
dikgobokanyo	d i kx O b O k> a J O
baseline	b a s E l i n E
tshware	tsh w a r E
arabile	a r a b i l E
masweng	m a s w E N
rwesa	r w E s a
katlaatlelong	k> a tl> a tl> E l O N
ratwa	r a t> w a
ikgotsofaditse	i kx O ts> O f a d i ts> E
mokwatleng	m O k> w a tl> E N
kalafi	k> a l a f i
dikgadima	d i kx a d i m a
itlhamela	i tlh a m E l a
enta	E n t> a
mametlelelwa	m a m E tl> E l E l w a
lebogisiwa	l E b O x i s i w a
lengweng	l E N w E N
karolothutong	k> a r O l O th u t> O N
tlamelwang	tl> a m E l w a N
manobonobo	m a n O b O n O b O
tlole	tl> O l E
busetseng	b u s E ts> E N
ipitsang	i p> i ts> a N
dipharasaete	d i ph a r a s a E t> E
kgopisege	kx O p> i s E x E
tlhodia	tlh O d i a
ikarabelelang	i k> a r a b E l E l a N
neelaneng	n E E l a n E N
senotsweng	s E n O ts> w E N
ithaopa	i th a O p> a
tshenyo	tsh E J O
batlisise	b a tl> i s i s E
porojeke	p> O r O d0Z E k> E
lepetleke	l E p> E tl> E k> E
bewa	b E w a
bokgope	b O kx O p> E
bonyatsi	b O J a ts> i
latswega	l a ts> w E x a
tsuba	ts> u b a
dinagang	d i n a x a N
moagong	m O a x O N
thopa	th O p> a
ponelomorago	p> O n E l O m O r a x O
ntsifatso	n ts> i f a ts> O
diphufudi	d i ph u f u d i
utswitsweng	u ts> w i ts> w E N
tebileng	t> E b i l E N
dimela	d i m E l a
khalesiamo	kh a l E s i a m O
talafaditse	t> a l a f a d i ts> E
golagantswe	x O l a x a n ts> w E
dipadi	d i p> a d i
moele	m O E l E
maikutlong	m a i k> u tl> O N
loso	l O s O
sebedi	s E b E d i
pakatiro	p> a k> a t> i r O
segongwana	s E x O N w a n a
mokhutshwane	m O kh u tsh w a n E
matseno	m a ts> E n O
molelwane	m O l E l w a n E
maotwaneng	m a O t> w a n E N
lotlelela	l O tl> E l E l a
motsheo	m O tsh E O
baabedi	b a b E d i
rerelwa	r E r E l w a
botlhokong	b O tlh O k> O N
ipone	i p> O n E
ditlhare	d i tlh a r E
thologelo	th O l O x E l O
nkoko	n k> O k> O
tswele	ts> w E l E
molaetsa	m O l a E ts> a
tirelopuso	t> i r E l O p> u s O
kgatelopele	kx a t> E l O p> E l E
tlogelwa	tl> O x E l w a
tikwatikweng	t> i k> w a t> i k> w E N
kgaritlha	kx a r i tlh a
kgethilweng	kx E th i l w E N
letlelelang	l E tl> E l E l a N
apesitswe	a p> E s i ts> w E
melawana	m E l a w a n a
magato	m a x a t> O
kgothatsa	kx O th a ts> a
belaetsa	b E l a E ts> a
okometse	O k> O m E ts> E
ntsho	n tsh O
robaletseng	r O b a l E ts> E N
saenisa	s a E n i s a
kua	k> u a
gangwe	x a N w E
ditereneng	d i t> E r E n E N
solofetsang	s O l O f E ts> a N
dikhoping	d i kh O p> i N
katisitsweng	k> a t> i s i ts> w E N
bonyabonya	b O J a b O J a
tabogisa	t> a b O x i s a
fitlhetse	f i tlh E ts> E
ngongorega	N O N O r E x a
molelong	m O l E l O N
katoga	k> a t> O x a
ipelaetsang	i p> E l a E ts> a N
montsho	m O n tsh O
fitlhelwang	f i tlh E l w a N
tlotle	tl> O tl> E
ditshupetso	d i tsh u p> E ts> O
kgotlelang	kx O tl> E l a N
tlhakanelang	tlh a k> a n E l a N
ntigela	n t> i x E l a
namoneite	n a m O n E i t> E
etsisang	E ts> i s a N
bokao	b O k> a O
modiredi	m O d i r E d i
kgotletsweng	kx O tl> E ts> w E N
sekaenyana	s E k> a E J a n a
boelelang	b O E l E l a N
tilweng	t> i l w E N
fetogileng	f E t> O x i l E N
semphete	s E m ph E t> E
kgotlatshekelokgolo	kx O tl> a tsh E k> E l O kx O l O
botlolong	b O tl> O l O N
tlhagelelong	tlh a x E l E l O N
lekgotlatoropong	l E kx O tl> a t> O r O p> O N
kabelanong	k> a b E l a n O N
beleseditswe	b E l E s E d i ts> w E
potokwa	p> O t> O k> w a
tiiseditse	t> i i s E d i ts> E
fokotsa	f O k> O ts> a
tshupa	tsh u p> a
phasalatsong	ph a s a l a ts> O N
boitshwarong	b O i tsh w a r O N
ditlhwatlhwa	d i tlh w a tlh w a
tsenele	ts> E n E l E
katamelano	k> a t> a m E l a n O
somerobongwe	s O m E r O b O N w E
boatlhoding	b O a tlh O d i N
botlhokomedi	b O tlh O k> O m E d i
obege	O b E x E
latlhegetswe	l a tlh E x E ts> w E
tlo	tl> O
bobolang	b O b O l a N
ditsopotla	d i ts> O p> O tl> a
thokwana	th O k> w a n a
ja	d0Z a
tlelatšhe	tl> E l a tSh E
khunologo	kh u n O l O x O
ausi	a u s i
hirile	h i r i l E
ntsinyana	n ts> i J a n a
itshware	i tsh w a r E
tesetamenteng	t> E s E t> a m E n t> E N
boitumediso	b O i t> u m E d i s O
eletsege	E l E ts> E x E
kgonago	kx O n a x O
tshubilweng	tsh u b i l w E N
itheileng	i th E i l E N
dikolosiwa	d i k> O l O s i w a
mpampetsa	m p> a m p> E ts> a
ntswe	n ts> w E
timelela	t> i m E l E l a
dibetlela	d i b E tl> E l a
dikgoropa	d i kx O r O p> a
tlhola	tlh O l a
rarabolotswe	r a r a b O l O ts> w E
itsang	i ts> a N
lona	l O n a
esi	E s i
dipositi	d i p> O s i t> i
pina	p> i n a
eletsa	E l E ts> a
tloletsa	tl> O l E ts> a
nkutlwisa	n k> u tl> w i s a
ditebego	d i t> E b E x O
mmolaetse	m m O l a E ts> E
gagabisa	x a x a b i s a
tsamaelaneng	ts> a m a E l a n E N
latlhegileng	l a tlh E x i l E N
dipapatsong	d i p> a p> a ts> O N
tshoge	tsh O x E
boitumelo	b O i t> u m E l O
tsweletsopele	ts> w E l E ts> O p> E l E
bomasenyeletsa	b O m a s E J E l E ts> a
lehumo	l E h u m O
sebolaya	s E b O l a j a
lakaila	l a k> a i l a
lefaphang	l E f a ph a N
monwana	m O n w a n a
banka	b a n k> a
sepe	s E p> E
rototse	r O t> O ts> E
kampo	k> a m p> O
dithutlwa	d i th u tl> w a
bolawang	b O l a w a N
tlhalosetso	tlh a l O s E ts> O
thoteng	th O t> E N
towe	t> O w E
kokoanya	k> O k> O a J a
dintlhakgolo	d i n tlh a kx O l O
phaposikgaso	ph a p> O s i kx a s O
nteletsa	n t> E l E ts> a
bojalweng	b O d0Z a l w E N
theipi	th E i p> i
tlhatlhobilweng	tlh a tlh O b i l w E N
matsatsi	m a ts> a ts> i
mokonteraka	m O k> O n t> E r a k> a
morethetho	m O r E th E th O
arogana	a r O x a n a
dijo	d i d0Z O
moseleng	m O s E l E N
ntheetse	n th E E ts> E
bagaetsho	b a x a E tsh O
gatisitsweng	x a t> i s i ts> w E N
beele	b E E l E
santlha	s a n tlh a
dihakaboi	d i h a k> a b O i
gaswa	x a s w a
itshegeletsang	i tsh E x E l E ts> a N
botsolotsa	b O ts> O l O ts> a
tshosobanyo	tsh O s O b a J O
bonagalang	b O n a x a l a N
motlhapeng	m O tlh a p> E N
taletso	t> a l E ts> O
itebagantse	i t> E b a x a n ts> E
palogotlhe	p> a l O x O tlh E
potlako	p> O tl> a k> O
tshwannang	tsh w a n n a N
dithekenikoneng	d i th E k> E n i k> O n E N
maleele	m a l E E l E
kopantsha	k> O p> a n tsh a
elele	E l E l E
tlhatlhelelo	tlh a tlh E l E l O
kolotang	k> O l O t> a N
setoropo	s E t> O r O p> O
bosiamising	b O s i a m i s i N
ditshingwana	d i tsh i N w a n a
gwetlhiwa	x w E tlh i w a
mawatle	m a w a tl> E
bonngwe	b O n N w E
dithamaga	d i th a m a x a
bopegileng	b O p> E x i l E N
kgotlhelo	kx O tlh E l O
iketla	i k> E tl> a
tsietso	ts> i E ts> O
atlenegisa	a tl> E n E x i s a
bogodimo	b O x O d i m O
motlotlo	m O tl> O tl> O
latetsweng	l a t> E ts> w E N
tatlhegelong	t> a tlh E x E l O N
lefikantswe	l E f i k> a n ts> w E
goeletsang	x O E l E ts> a N
ipelaetsa	i p> E l a E ts> a
nyetseng	J E ts> E N
thibela	th i b E l a
medi	m E d i
ikgatholoseng	i kx a th O l O s E N
wetswe	w E ts> w E
ikwadisa	i k> w a d i s a
latsa	l a ts> a
nona	n O n a
tselapedi	ts> E l a p> E d i
tlhokisa	tlh O k> i s a
bakiwang	b a k> i w a N
sebakeng	s E b a k> E N
farolagana	f a r O l a x a n a
dithentara	d i th E n t> a r a
semelafa	s E m E l a f a
tlhakanngwe	tlh a k> a n N w E
tsamaisane	ts> a m a i s a n E
papetlana	p> a p> E tl> a n a
boemafofane	b O E m a f O f a n E
gontsintsi	x O n ts> i n ts> i
dipompokgolo	d i p> O m p> O kx O l O
metseletseleng	m E ts> E l E ts> E l E N
balele	b a l E l E
dithutong	d i th u t> O N
porofešenale	p> O r O f E S E n a l E
tlosiwang	tl> O s i w a N
feng	f E N
gaketse	x a k> E ts> E
abiwe	a b i w E
fitlhele	f i tlh E l E
itlhokomolose	i tlh O k> O m O l O s E
phalang	ph a l a N
maswabi	m a s w a b i
koo	k> O O
sepeiting	s E p> E i t> i N
botlhalefi	b O tlh a l E f i
sekorolo	s E k> O r O l O
letileng	l E t> i l E N
fofane	f O f a n E
ikopelang	i k> O p> E l a N
sedimoseditswe	s E d i m O s E d i ts> w E
itlhoma	i tlh O m a
tsibogetse	ts> i b O x E ts> E
bosiamisi	b O s i a m i s i
magonego	m a x O n E x O
tlotlomaditseng	tl> O tl> O m a d i ts> E N
ntlhatharo	n tlh a th a r O
diphororo	d i ph O r O r O
bolokesegile	b O l O k> E s E x i l E
phuaganya	ph u a x a J a
utlwang	u tl> w a N
gobalang	x O b a l a N
rarabologang	r a r a b O l O x a N
tsenyeletsa	ts> E J E l E ts> a
tsidifatse	ts> i d i f a ts> E
togamaanong	t> O x a m a n O N
porojekeng	p> O r O d0Z E k> E N
kemokgatlhanong	k> E m O kx a tlh a n O N
relele	r E l E l E
leswefadiwa	l E s w E f a d i w a
busiwang	b u s i w a N
tshitshinngwang	tsh i tsh i n N w a N
rema	r E m a
nosa	n O s a
ntshosetsang	n tsh O s E ts> a N
ditegeniki	d i t> E x E n i k> i
itshegetso	i tsh E x E ts> O
dumelelwa	d u m E l E l w a
tladitseng	tl> a d i ts> E N
polokesego	p> O l O k> E s E x O
tshenko	tsh E n k> O
tlhotlholola	tlh O tlh O l O l a
didirwa	d i d i r w a
letsomane	l E ts> O m a n E
mogatsaake	m O x a ts> a k> E
dikologang	d i k> O l O x a N
atolosa	a t> O l O s a
pitlaganeng	p> i tl> a x a n E N
matshelong	m a tsh E l O N
khuduga	kh u d u x a
metse	m E ts> E
boripana	b O r i p> a n a
bapisegang	b a p> i s E x a N
kgaogangwe	kx a O x a N w E
ipagololela	i p> a x O l O l E l a
fudisa	f u d i s a
kare	k> a r E
siamisetsa	s i a m i s E ts> a
feteletseng	f E t> E l E ts> E N
ineela	i n E E l a
tshoboloko	tsh O b O l O k> O
fetisediweng	f E t> i s E d i w E N
anega	a n E x a
mothofatso	m O th O f a ts> O
tekanyong	t> E k> a J O N
gakolosang	x a k> O l O s a N
diteki	d i t> E k> i
polokegong	p> O l O k> E x O N
kgaisanong	kx a i s a n O N
golafatsa	x O l a f a ts> a
kgaka	kx a k> a
tafoleng	t> a f O l E N
mokwadising	m O k> w a d i s i N
boithutelotiro	b O i th u t> E l O t> i r O
dibaesekele	d i b a E s E k> E l E
dibitamini	d i b i t> a m i n i
gotlholela	x O tlh O l E l a
thibeleng	th i b E l E N
thebe	th E b E
tleliniki	tl> E l i n i k> i
diakere	d i a k> E r E
dirukutlhi	d i r u k> u tlh i
ditlelereke	d i tl> E l E r E k> E
bolokelwa	b O l O k> E l w a
saenela	s a E n E l a
jesiwa	d0Z E s i w a
lekgoba	l E kx O b a
lemositse	l E m O s i ts> E
atlholwang	a tlh O l w a N
dikgatisong	d i kx a t> i s O N
tirisanong	t> i r i s a n O N
thutong	th u t> O N
tlhokomelesegileng	tlh O k> O m E l E s E x i l E N
ketekang	k> E t> E k> a N
dikarolothutong	d i k> a r O l O th u t> O N
sikarwang	s i k> a r w a N
megojwana	m E x O d0Z w a n a
barutabana	b a r u t> a b a n a
ikgobokanyetsa	i kx O b O k> a J E ts> a
telele	t> E l E l E
boatleng	b O a tl> E N
malatsing	m a l a ts> i N
tlhoboga	tlh O b O x a
tshupane	tsh u p> a n E
sekgamung	s E kx a m u N
tlholele	tlh O l E l E
lapisa	l a p> i s a
moromiwa	m O r O m i w a
ruteng	r u t> E N
namile	n a m i l E
gakolola	x a k> O l O l a
ditlha	d i tlh a
dinonyana	d i n O J a n a
ipusa	i p> u s a
sitlhamololela	s i tlh a m O l O l E l a
dijenale	d i d0Z E n a l E
karabong	k> a r a b O N
tlhokomela	tlh O k> O m E l a
phologolo	ph O l O x O l O
kgelegetlwa	kx E l E x E tl> w a
sobokantswe	s O b O k> a n ts> w E
dipolane	d i p> O l a n E
khumanego	kh u m a n E x O
belaetsang	b E l a E ts> a N
rwesitswe	r w E s i ts> w E
dithobane	d i th O b a n E
ithutetseng	i th u t> E ts> E N
dutilweng	d u t> i l w E N
phutheletse	ph u th E l E ts> E
tsenang	ts> E n a N
ditshoding	d i tsh O d i N
molongwana	m O l O N w a n a
phokotsego	ph O k> O ts> E x O
apola	a p> O l a
dinamagadi	d i n a m a x a d i
mmoloki	m m O l O k> i
dithaereng	d i th a E r E N
betologa	b E t> O l O x a
tlhabanong	tlh a b a n O N
sefaleng	s E f a l E N
laisolola	l a i s O l O l a
tlhasenyana	tlh a s E J a n a
makgoa	m a kx O a
katisediwa	k> a t> i s E d i w a
seswati	s E s w a t> i
amogelese	a m O x E l E s E
ditatso	d i t> a ts> O
mabati	m a b a t> i
difane	d i f a n E
thubela	th u b E l a
supiwe	s u p> i w E
ngaletse	N a l E ts> E
gasagasa	x a s a x a s a
nare	n a r E
loba	l O b a
tsweleletsa	ts> w E l E l E ts> a
ditlhaloganyo	d i tlh a l O x a J O
tswaka	ts> w a k> a
gakololana	x a k> O l O l a n a
ribolola	r i b O l O l a
alafa	a l a f a
dipheko	d i ph E k> O
tlotlomatsang	tl> O tl> O m a ts> a N
dikhurumelo	d i kh u r u m E l O
puseletso	p> u s E l E ts> O
ruanyang	r u a J a N
mohumagatsana	m O h u m a x a ts> a n a
botsalano	b O ts> a l a n O
gatisetsa	x a t> i s E ts> a
madinyana	m a d i J a n a
poleite	p> O l E i t> E
lebela	l E b E l a
kgaitsadi	kx a i ts> a d i
melemo	m E l E m O
makgwafo	m a kx w a f O
moagi	m O a x i
difeme	d i f E m E
khoramo	kh O r a m O
tlantswe	tl> a n ts> w E
dipetlele	d i p> E tl> E l E
ditshwantsho	d i tsh w a n tsh O
senyetsa	s E J E ts> a
kwalela	k> w a l E l a
ntlotle	n tl> O tl> E
tshedimosetsong	tsh E d i m O s E ts> O N
laeboraring	l a E b O r a r i N
fisetsa	f i s E ts> a
baetapele	b a E t> a p> E l E
supolola	s u p> O l O l a
borokwa	b O r O k> w a
amanya	a m a J a
fetisa	f E t> i s a
kgorwana	kx O r w a n a
ditswaki	d i ts> w a k> i
mogatlana	m O x a tl> a n a
seisamadi	s E i s a m a d i
duelela	d u E l E l a
phalalo	ph a l a l O
itshwaya	i tsh w a j a
fokodiwa	f O k> O d i w a
tlolela	tl> O l E l a
kokobatsa	k> O k> O b a ts> a
leletsa	l E l E ts> a
rabana	r a b a n a
materaseng	m a t> E r a s E N
sedimosa	s E d i m O s a
phuthela	ph u th E l a
kwadisitse	k> w a d i s i ts> E
bomatla	b O m a tl> a
itshwarele	i tsh w a r E l E
tolamo	t> O l a m O
baabing	b a b i N
boemafofaneng	b O E m a f O f a n E N
tswelela	ts> w E l E l a
bannye	b a n J E
kobela	k> O b E l a
monyo	m O J O
thatong	th a t> O N
pegiwa	p> E x i w a
mpimpi	m p> i m p> i
kwano	k> w a n O
sefapaano	s E f a p> a n O
fitlhilwe	f i tlh i l w E
ntshala	n tsh a l a
logetswe	l O x E ts> w E
kgodisong	kx O d i s O N
felong	f E l O N
tsweleleng	ts> w E l E l E N
badilweng	b a d i l w E N
sutisediwang	s u t> i s E d i w a N
tshubiwe	tsh u b i w E
amegileng	a m E x i l E N
diromelwantleng	d i r O m E l w a n tl> E N
dibakwa	d i b a k> w a
mmaraka	m m a r a k> a
kubugela	k> u b u x E l a
bajading	b a d0Z a d i N
diphefong	d i ph E f O N
njo	n d0Z O
thusana	th u s a n a
kgomarelang	kx O m a r E l a N
yoo	j O O
dingweng	d i N w E N
tlanyo	tl> a J O
somola	s O m O l a
etleediwa	E tl> E E d i w a
kwadisiwe	k> w a d i s i w E
tshwanelwa	tsh w a n E l w a
botlhabelo	b O tlh a b E l O
tekelelong	t> E k> E l E l O N
lomaganngwa	l O m a x a n N w a
saenang	s a E n a N
setempe	s E t> E m p> E
dikgaga	d i kx a x a
pejana	p> E d0Z a n a
fokotsege	f O k> O ts> E x E
mmina	m m i n a
ditlhabololong	d i tlh a b O l O l O N
matamong	m a t> a m O N
bojang	b O d0Z a N
baaging	b a x i N
tsidifadiwa	ts> i d i f a d i w a
kgotsofatsang	kx O ts> O f a ts> a N
maatleng	m a tl> E N
ipopile	i p> O p> i l E
leswana	l E s w a n a
puong	p> u O N
tlhabololo	tlh a b O l O l O
bonela	b O n E l a
romeletsweng	r O m E l E ts> w E N
dikarolong	d i k> a r O l O N
keleletso	k> E l E l E ts> O
ngodiegong	N O d i E x O N
busang	b u s a N
etetswe	E t> E ts> w E
akarediwe	a k> a r E d i w E
tlhakaneng	tlh a k> a n E N
thulwa	th u l w a
popomatsa	p> O p> O m a ts> a
modidi	m O d i d i
rwesang	r w E s a N
tletseng	tl> E ts> E N
manontlhotlho	m a n O n tlh O tlh O
matlhabelong	m a tlh a b E l O N
emisitseng	E m i s i ts> E N
tlalelwe	tl> a l E l w E
lorato	l O r a t> O
tlopelo	tl> O p> E l O
ngongoregang	N O N O r E x a N
gapelesega	x a p> E l E s E x a
baruing	b a r u i N
tshegofadiwe	tsh E x O f a d i w E
aparetseng	a p> a r E ts> E N
ikobele	i k> O b E l E
senolang	s E n O l a N
busetsa	b u s E ts> a
borokgwe	b O r O kx w E
kae	k> a E
diphuthegong	d i ph u th E x O N
tsogileng	ts> O x i l E N
epela	E p> E l a
utlwe	u tl> w E
sutisa	s u t> i s a
fedileng	f E d i l E N
aloga	a l O x a
tsosolosong	ts> O s O l O s O N
magoro	m a x O r O
itlhokomolosa	i tlh O k> O m O l O s a
dibukeng	d i b u k> E N
beteletse	b E t> E l E ts> E
bagwebing	b a x w E b i N
gelwa	x E l w a
arabelang	a r a b E l a N
bontlhopheng	b O n tlh O ph E N
borakanelong	b O r a k> a n E l O N
mosima	m O s i m a
dikeleko	d i k> l E k> O
digongwaneng	d i x O N w a n E N
tekolo	t> E k> O l O
tswapatswapela	ts> w a p> a ts> w a p> E l a
itshenyetsa	i tsh E J E ts> a
diabo	d i a b O
maparego	m a p> a r E x O
dikokomaneng	d i k> O k> O m a n E N
rekisetse	r E k> i s E ts> E
leleng	l E l E N
tlasenyana	tl> a s E J a n a
ikgolaganya	i kx O l a x a J a
mafapheng	m a f a ph E N
jeokerafi	d0Z E O k> E r a f i
befa	b E f a
mabaka	m a b a k> a
poso	p> O s O
totobaditsweng	t> O t> O b a d i ts> w E N
tlhamang	tlh a m a N
kapodisa	k> a p> O d i s a
ditatofatso	d i t> a t> O f a ts> O
fodile	f O d i l E
phelang	ph E l a N
laolege	l a O l E x E
ntseetse	n ts> E E ts> E
konalo	k> O n a l O
kgotlelela	kx O tl> E l E l a
naganela	n a x a n E l a
mokomišinara	m O k> O m i S i n a r a
phogwana	ph O x w a n a
rarololwang	r a r O l O l w a N
lefisiwa	l E f i s i w a
matseba	m a ts> E b a
gelela	x E l E l a
nositseng	n O s i ts> E N
difolaga	d i f O l a x a
pitlaganngwa	p> i tl> a x a n N w a
makhutshwane	m a kh u tsh w a n E
ngotliwa	N O tl> i w a
tshosologo	tsh O s O l O x O
kankere	k> a n k> E r E
tsentsweng	ts> E n ts> w E N
itsenya	i ts> E J a
fediweng	f E d i w E N
tlisetsa	tl> i s E ts> a
nyatseng	J a ts> E N
tlhabololang	tlh a b O l O l a N
ikilele	i k> i l E l E
thanele	th a n E l E
batlhano	b a tlh a n O
leana	l E a n a
atlhameng	a tlh a m E N
lotlhe	l O tlh E
kheibole	kh E i b O l E
mehuta	m E h u t> a
tsosang	ts> O s a N
bokoloniale	b O k> O l O n i a l E
jwa	d0Z w a
kakanyetso	k> a k> a J E ts> O
paakanyo	p> a k> a J O
bantshong	b a n tsh O N
balosika	b a l O s i k> a
tsalwang	ts> a l w a N
sekegilweng	s E k> E x i l w E N
tatlhegelo	t> a tlh E x E l O
bidio	b i d i O
tlhaselwang	tlh a s E l w a N
rekotong	r E k> O t> O N
ditsibogelo	d i ts> i b O x E l O
bolelelang	b O l E l E l a N
somamatlhano	s O m a m a tlh a n O
nametsa	n a m E ts> a
gakilwe	x a k> i l w E
masego	m a s E x O
mabeelo	m a b E E l O
boitirelo	b O i t> i r E l O
ithekela	i th E k> E l a
gotleng	x O tl> E N
tirelong	t> i r E l O N
rekang	r E k> a N
gamaregile	x a m a r E x i l E
lobotana	l O b O t> a n a
maatlafadiwe	m a tl> a f a d i w E
imena	i m E n a
thusega	th u s E x a
tsie	ts> i E
tlogelwang	tl> O x E l w a N
simololeng	s i m O l O l E N
tlhabang	tlh a b a N
basepedi	b a s E p> E d i
bantsintsi	b a n ts> i n ts> i
bolelelwang	b O l E l E l w a N
bonetetshi	b O n E t> E tsh i
dikakanyong	d i k> a k> a J O N
phisego	ph i s E x O
buisang	b u i s a N
bayang	b a j a N
raro	r a r O
tshegetsang	tsh E x E ts> a N
tlhaeletsana	tlh a E l E ts> a n a
dumelelana	d u m E l E l a n a
ranolela	r a n O l E l a
tshwaraganeng	tsh w a r a x a n E N
salate	s a l a t> E
ikaba	i k> a b a
mmatleng	m m a tl> E N
boikano	b O i k> a n O
umakiwang	u m a k> i w a N
thekenoloji	th E k> E n O l O d0Z i
medileng	m E d i l E N
rejisetara	r E d0Z i s E t> a r a
ditshoutiso	d i tsh O u t> i s O
dibokwana	d i b O k> w a n a
baya	b a j a
bontle	b O n tl> E
methalo	m E th a l O
mafelobonnong	m a f E l O b O n n O N
mapodisa	m a p> O d i s a
dintana	d i n t> a n a
metsotso	m E ts> O ts> O
kgogodi	kx O x O d i
dithobego	d i th O b E x O
rakanela	r a k> a n E l a
mokokotlo	m O k> O k> O tl> O
mefama	m E f a m a
itlisa	i tl> i s a
kgaotsa	kx a O ts> a
senola	s E n O l a
simolotse	s i m O l O ts> E
tseeletswa	ts> E E l E ts> w a
dikarolo	d i k> a r O l O
tshiamololo	tsh i a m O l O l O
abetswe	a b E ts> w E
ramarumo	r a m a r u m O
diphasalatso	d i ph a s a l a ts> O
mokgatlhong	m O kx a tlh O N
tshwereng	tsh w E r E N
babui	b a b u i
fudugetse	f u d u x E ts> E
utlwiwang	u tl> w i w a N
thuma	th u m a
moferong	m O f E r O N
tlhoga	tlh O x a
phola	ph O l a
sepetseng	s E p> E ts> E N
monyela	m O J E l a
inaya	i n a j a
tsadiso	ts> a d i s O
ipaakanyo	i p> a k> a J O
jeke	d0Z E k> E
solofetsa	s O l O f E ts> a
tladitsweng	tl> a d i ts> w E N
morwadiake	m O r w a d i a k> E
karolo	k> a r O l O
bonana	b O n a n a
akantseng	a k> a n ts> E N
kgaratlhang	kx a r a tlh a N
tshomarelo	tsh O m a r E l O
mmasepala	m m a s E p> a l a
borapedi	b O r a p> E d i
madume	m a d u m E
ganelang	x a n E l a N
tlhabilwe	tlh a b i l w E
fele	f E l E
bagale	b a x a l E
dipopegong	d i p> O p> E x O N
boang	b O a N
tshabegang	tsh a b E x a N
pogisego	p> O x i s E x O
ngapa	N a p> a
makalela	m a k> a l E l a
lentswe	l E n ts> w E
tlhometse	tlh O m E ts> E
boapeelong	b O a p> E E l O N
ditlhakeng	d i tlh a k> E N
yono	j O n O
lebise	l E b i s E
tlwaelang	tl> w a E l a N
tlalelong	tl> a l E l O N
kopantsweng	k> O p> a n ts> w E N
tshekaganyang	tsh E k> a x a J a N
ntlhalosetsa	n tlh a l O s E ts> a
nwela	n w E l a
bofilwe	b O f i l w E
kgaotsweng	kx a O ts> w E N
boipolelo	b O i p> O l E l O
batlisisiwang	b a tl> i s i s i w a N
motšhotšho	m O tSh O tSh O
kgato	kx a t> O
inagana	i n a x a n a
ditopong	d i t> O p> O N
tlhotlhomise	tlh O tlh O m i s E
rutilweng	r u t> i l w E N
pumpunyega	p> u m p> u J E x a
ditaelong	d i t> a E l O N
kodu	k> O d u
kgobokanyang	kx O b O k> a J a N
mosweu	m O s w E u
tlhanole	tlh a n O l E
pasa	p> a s a
direlana	d i r E l a n a
dibaesekopong	d i b a E s E k> O p> O N
tatlhegong	t> a tlh E x O N
kukile	k> u k> i l E
busiweng	b u s i w E N
bagae	b a x a E
motlakaseng	m O tl> a k> a s E N
ditumalanong	d i t> u m a l a n O N
latlhegetsweng	l a tlh E x E ts> w E N
dipontshotshupetso	d i p> O n tsh O tsh u p> E ts> O
kgole	kx O l E
rarabololeng	r a r a b O l O l E N
thempereitšha	th E m p> E r E i tSh a
ntlwana	n tl> w a n a
akgolwa	a kx O l w a
fofelang	f O f E l a N
etelwa	E t> E l w a
sekgwage	s E kx w a x E
dikausu	d i k> a u s u
dumelele	d u m E l E l E
dupelela	d u p> E l E l a
fetola	f E t> O l a
ditšhabatšhaba	d i tSh a b a tSh a b a
rotloetse	r O tl> O E ts> E
itsetsepetseng	i ts> E ts> E p> E ts> E N
diji	d i d0Z i
tsholwang	tsh O l w a N
etsa	E ts> a
phimotse	ph i m O ts> E
kgolong	kx O l O N
itekanelang	i t> E k> a n E l a N
matsadi	m a ts> a d i
tlhaloseng	tlh a l O s E N
ipaakanyetse	i p> a k> a J E ts> E
thibelwa	th i b E l w a
thutoloago	th u t> O l O a x O
kalafo	k> a l a f O
maisemane	m a i s E m a n E
pompela	p> O m p> E l a
motlhagisi	m O tlh a x i s i
digokgo	d i x O kx O
kokoano	k> O k> O a n O
tsweletsang	ts> w E l E ts> a N
pheula	ph E u l a
swetsa	s w E ts> a
bontsho	b O n tsh O
gakgamale	x a kx a m a l E
diamusi	d i a m u s i
kailweng	k> a i l w E N
tlhomologile	tlh O m O l O x i l E
botlhokotlhoko	b O tlh O k> O tlh O k> O
ratwang	r a t> w a N
lemosega	l E m O s E x a
maikaelelong	m a i k> a E l E l O N
mokaulengwe	m O k> a u l E N w E
fedisitswe	f E d i s i ts> w E
tsamaileng	ts> a m a i l E N
moagisane	m O a x i s a n E
iketlang	i k> E tl> a N
moatshe	m O a tsh E
dikgaso	d i kx a s O
moiphemedi	m O i ph E m E d i
dikgopo	d i kx O p> O
ditlhongwa	d i tlh O N w a
robaleng	r O b a l E N
rebolwang	r E b O l w a N
maithaopo	m a i th a O p> O
setsholetsi	s E tsh O l E ts> i
letloleng	l E tl> O l E N
kwadile	k> w a d i l E
jaana	d0Z a n a
ditlelafo	d i tl> E l a f O
makaleng	m a k> a l E N
magetleng	m a x E tl> E N
ntlhayang	n tlh a j a N
bošweng	b O S w E N
ngwetsi	N w E ts> i
marung	m a r u N
legorong	l E x O r O N
fise	f i s E
utswitswe	u ts> w i ts> w E
molaotheong	m O l a O th E O N
mpolaye	m p> O l a j E
kitsiso	k> i ts> i s O
dithapolo	d i th a p> O l O
abetse	a b E ts> E
tshwenyang	tsh w E J a N
tlung	tl> u N
ngoka	N O k> a
badirelwa	b a d i r E l w a
ikgogela	i kx O x E l a
dilo	d i l O
lenaanethuto	l E n a n E th u t> O
sutlha	s u tlh a
sewelo	s E w E l O
kgotsofalo	kx O ts> O f a l O
boutlwelobotlhoko	b O u tl> w E l O b O tlh O k> O
abelwe	a b E l w E
menoga	m E n O x a
tlhaloganngwa	tlh a l O x a n N w a
