tlamong	tl> a m O N
letseng	l E ts> E N
itlhopha	i tlh O ph a
maparegong	m a p> a r E x O N
tlhobogile	tlh O b O x i l E
tswale	ts> w a l E
botlhoki	b O tlh O k> i
bogagapa	b O x a x a p> a
sefelekwane	s E f E l E k> w a n E
maru	m a r u
khupeditswe	kh u p> E d i ts> w E
boikgopolo	b O i kx O p> O l O
sebipo	s E b i p> O
golole	x O l O l E
phatlalatso	ph a tl> a l a ts> O
matlhagatlhaga	m a tlh a x a tlh a x a
gogiwa	x O x i w a
thuanyong	th u a J O N
moimana	m O i m a n a
lengau	l E N a u
nyalaneng	J a l a n E N
lora	l O r a
tshimo	tsh i m O
phosolola	ph O s O l O l a
motlhagare	m O tlh a x a r E
tsofetseng	ts> O f E ts> E N
tsamaetse	ts> a m a E ts> E
lekaneng	l E k> a n E N
gateletse	x a t> E l E ts> E
tokologong	t> O k> O l O x O N
reketlisa	r E k> E tl> i s a
kgolwane	kx O l w a n E
itumeleng	i t> u m E l E N
ntswa	n ts> w a
aroganeng	a r O x a n E N
tshimololo	tsh i m O l O l O
ditalente	d i t> a l E n t> E
kakabalo	k> a k> a b a l O
tlelorini	tl> E l O r i n i
dipalelong	d i p> a l E l O N
kopantshwang	k> O p> a n tsh w a N
tlhakolothoto	tlh a k> O l O th O t> O
thunye	th u J E
metsamao	m E ts> a m a O
mosetsana	m O s E ts> a n a
sekiwa	s E k> i w a
obamelwe	O b a m E l w E
tekanyetsong	t> E k> a J E ts> O N
fapogela	f a p> O x E l a
tebo	t> E b O
lekeletsa	l E k> E l E ts> a
batlhatlheledi	b a tlh a tlh E l E d i
direko	d i r E k> O
paloyotlhe	p> a l O j O tlh E
dirame	d i r a m E
ledimo	l E d i m O
kgobokantsweng	kx O b O k> a n ts> w E N
boikgethelong	b O i kx E th E l O N
tshwarelo	tsh w a r E l O
tlhalosetse	tlh a l O s E ts> E
tsenela	ts> E n E l a
kgagogong	kx a x O x O N
tlhokafaletse	tlh O k> a f a l E ts> E
lapisitswe	l a p> i s i ts> w E
tatelanong	t> a t> E l a n O N
babogedi	b a b O x E d i
kgwetlhong	kx w E tlh O N
emeng	E m E N
gwetlhang	x w E tlh a N
senyegelwa	s E J E x E l w a
gakolotswe	x a k> O l O ts> w E
jesang	d0Z E s a N
efogeng	E f O x E N
tshwaragano	tsh w a r a x a n O
ditlhobolo	d i tlh O b O l O
tlhaloswang	tlh a l O s w a N
ditsuatsue	d i ts> u a ts> u E
efoga	E f O x a
tshwarwe	tsh w a r w E
mogaetsho	m O x a E tsh O
sute	s u t> E
baakanngwang	b a k> a n N w a N
ngunanguna	N u n a N u n a
tlotla	tl> O tl> a
kgaleng	kx a l E N
boaging	b O a x i N
tlamilwe	tl> a m i l w E
ipofe	i p> O f E
batsaakarolo	b a ts> a k> a r O l O
pelo	p> E l O
disaenseng	d i s a E n s E N
mantswe	m a n ts> w E
tlhatlhobelwang	tlh a tlh O b E l w a N
kitlano	k> i tl> a n O
tladitswe	tl> a d i ts> w E
opelela	O p> E l E l a
tshwaretse	tsh w a r E ts> E
tshujwa	tsh u d0Z w a
tlotlomatso	tl> O tl> O m a ts> O
setefikeiting	s E t> E f i k> E i t> i N
bogatsu	b O x a ts> u
tswakanya	ts> w a k> a J a
matha	m a th a
ditlhomamiso	d i tlh O m a m i s O
baphasalatsing	b a ph a s a l a ts> i N
mogwanto	m O x w a n t> O
itlamang	i tl> a m a N
lekanya	l E k> a J a
mpiletsa	m p> i l E ts> a
atameditse	a t> a m E d i ts> E
ditshenyego	d i tsh E J E x O
ditshipi	d i tsh i p> i
dipholong	d i ph O l O N
mametlelelo	m a m E tl> E l E l O
ganediwe	x a n E d i w E
ditherisanong	d i th E r i s a n O N
sehubang	s E h u b a N
agiwa	a x i w a
kakanyo	k> a k> a J O
lekgolo	l E kx O l O
serethe	s E r E th E
diphaposiborutelong	d i ph a p> O s i b O r u t> E l O N
tlwaediwa	tl> w a E d i w a
itumediseng	i t> u m E d i s E N
beletsa	b E l E ts> a
gofejane	x O f E d0Z a n E
metlhodi	m E tlh O d i
didimalang	d i d i m a l a N
dikgatholoso	d i kx a th O l O s O
dirisetswe	d i r i s E ts> w E
bokgabale	b O kx a b a l E
tiragatso	t> i r a x a ts> O
phedise	ph E d i s E
ditlolo	d i tl> O l O
thamo	th a m O
jetsweng	d0Z E ts> w E N
bofelofelo	b O f E l O f E l O
metshamekwane	m E tsh a m E k> w a n E
filiming	f i l i m i N
botelele	b O t> E l E l E
tswelelong	ts> w E l E l O N
monwi	m O n w i
baakanyetsi	b a k> a J E ts> i
belaetse	b E l a E ts> E
belaelang	b E l a E l a N
kgolafalo	kx O l a f a l O
tharabololong	th a r a b O l O l O N
ipelela	i p> E l E l a
fetolela	f E t> O l E l a
tshegwa	tsh E x w a
polane	p> O l a n E
godimodimo	x O d i m O d i m O
tshego	tsh E x O
lala	l a l a
bokhutlhong	b O kh u tlh O N
tseelwang	ts> E E l w a N
matsapa	m a ts> a p> a
bafatlhosi	b a f a tlh O s i
kgopotso	kx O p> O ts> O
tlatsang	tl> a ts> a N
tsereng	ts> E r E N
tshepisa	tsh E p> i s a
jeresi	d0Z E r E s i
katisiwa	k> a t> i s i w a
iphitlhe	i ph i tlh E
dipilara	d i p> i l a r a
kgopisang	kx O p> i s a N
lebogisa	l E b O x i s a
dingaka	d i N a k> a
atisa	a t> i s a
kgorometsa	kx O r O m E ts> a
kgwageditswe	kx w a x E d i ts> w E
rometswe	r O m E ts> w E
teteano	t> E t> E a n O
balang	b a l a N
sesupalebelo	s E s u p> a l E b E l O
kabo	k> a b O
senata	s E n a t> a
setepe	s E t> E p> E
dithala	d i th a l a
komakoma	k> O m a k> O m a
bogorogelo	b O x O r O x E l O
khutlisitswe	kh u tl> i s i ts> w E
boitshupo	b O i tsh u p> O
meriri	m E r i r i
molaoding	m O l a O d i N
godisiwa	x O d i s i w a
matlhapa	m a tlh a p> a
rweleng	r w E l E N
mokapotene	m O k> a p> O t> E n E
tshekiso	tsh E k> i s O
botennyeng	b O t> E n J E N
phato	ph a t> O
tlhatloseng	tlh a tl> O s E N
ntshwara	n tsh w a r a
babueledi	b a b u E l E d i
arabiwang	a r a b i w a N
tlolong	tl> O l O N
potsolotsong	p> O ts> O l O ts> O N
lebanwe	l E b a n w E
tshabeng	tsh a b E N
kakangwa	k> a k> a N w a
takilwe	t> a k> i l w E
nkobeng	n k> O b E N
gakolole	x a k> O l O l E
lerago	l E r a x O
tshwenyo	tsh w E J O
tlhotlhomisiwe	tlh O tlh O m i s i w E
boalo	b O a l O
gosomanang	x O s O m a n a N
gatisitseng	x a t> i s i ts> E N
phimola	ph i m O l a
latelanang	l a t> E l a n a N
kuka	k> u k> a
kgorogong	kx O r O x O N
ee	E E
potlakisa	p> O tl> a k> i s a
leroborobo	l E r O b O r O b O
mmaeneng	m m a E n E N
fodisa	f O d i s a
gapang	x a p> a N
tsentse	ts> E n ts> E
dipeelo	d i p> E E l O
ehee	E h E E
boga	b O x a
dithetsenyana	d i th E ts> E J a n a
maikaelelomagolo	m a i k> a E l E l O m a x O l O
posong	p> O s O N
gotlhola	x O tlh O l a
ikotlhaela	i k> O tlh a E l a
kgoromelediwa	kx O r O m E l E d i w a
sekepe	s E k> E p> E
difikantswe	d i f i k> a n ts> w E
tsenelwa	ts> E n E l w a
baakanyetswa	b a k> a J E ts> w a
poko	p> O k> O
tlhagiswang	tlh a x i s w a N
fomo	f O m O
phatloga	ph a tl> O x a
kgorosong	kx O r O s O N
tšhata	tSh a t> a
felelela	f E l E l E l a
dipolelonolo	d i p> O l E l O n O l O
phasepoto	ph a s E p> O t> O
natlafatsa	n a tl> a f a ts> a
setlhabi	s E tlh a b i
dumetse	d u m E ts> E
amogetsweng	a m O x E ts> w E N
betologang	b E t> O l O x a N
nonofile	n O n O f i l E
buisiwa	b u i s i w a
don't	d O n t>
lemegang	l E m E x a N
dumalana	d u m a l a n a
rekiseditse	r E k> i s E d i ts> E
dikgokaganong	d i kx O k> a x a n O N
mokwaledi	m O k> w a l E d i
leraga	l E r a x a
tšhotlhwa	tSh O tlh w a
ditlhotlhwa	d i tlh O tlh w a
bedileng	b E d i l E N
robeng	r O b E N
tshikinngwa	tsh i k> i n N w a
ngwagasomeng	N w a x a s O m E N
tlhagise	tlh a x i s E
tshabileng	tsh a b i l E N
resiti	r E s i t> i
ikgatolositswe	i kx a t> O l O s i ts> w E
monyelwa	m O J E l w a
tsholwa	tsh O l w a
pabalelong	p> a b a l E l O N
thibelelang	th i b E l E l a N
dirise	d i r i s E
lekakaba	l E k> a k> a b a
kgokedi	kx O k> E d i
bobotlana	b O b O tl> a n a
fole	f O l E
leleme	l E l E m E
malata	m a l a t> a
polelwana	p> O l E l w a n a
tlhagelelo	tlh a x E l E l O
tsokotsa	ts> O k> O ts> a
mokgabo	m O kx a b O
kabakanya	k> a b a k> a J a
sedimosediwe	s E d i m O s E d i w E
setatamenteng	s E t> a t> a m E n t> E N
motshwaedi	m O tsh w a E d i
khoutung	kh O u t> u N
marothodi	m a r O th O d i
bonelapele	b O n E l a p> E l E
setuki	s E t> u k> i
sefako	s E f a k> O
adile	a d i l E
tatelong	t> a t> E l O N
totobatsang	t> O t> O b a ts> a N
itshoke	i tsh O k> E
bokanakana	b O k> a n a k> a n a
tirisano	t> i r i s a n O
bolelela	b O l E l E l a
salele	s a l E l E
lonao	l O n a O
phuthologe	ph u th O l O x E
ditshwene	d i tsh w E n E
thefosano	th E f O s a n O
dilatlhwa	d i l a tlh w a
tsholo	tsh O l O
ditemana	d i t> E m a n a
ntsene	n ts> E n E
polasetiki	p> O l a s E t> i k> i
iponelwa	i p> O n E l w a
kutlobotlhokong	k> u tl> O b O tlh O k> O N
begilwe	b E x i l w E
bobola	b O b O l a
bomolemo	b O m O l E m O
bammala	b a m m a l a
nnela	n n E l a
atlhola	a tlh O l a
diphaposi	d i ph a p> O s i
tlhapela	tlh a p> E l a
tokafaditsweng	t> O k> a f a d i ts> w E N
anetse	a n E ts> E
leobu	l E O b u
tshwaneng	tsh w a n E N
nweng	n w E N
kgarakgatshwa	kx a r a kx a tsh w a
pagama	p> a x a m a
boimanosi	b O i m a n O s i
khuting	kh u t> i N
abelwa	a b E l w a
ikgata	i kx a t> a
utlwalang	u tl> w a l a N
dumela	d u m E l a
fokotswa	f O k> O ts> w a
tladi	tl> a d i
botlhe	b O tlh E
tlhokisana	tlh O k> i s a n a
rwesitse	r w E s i ts> E
reboletswe	r E b O l E ts> w E
fiwa	f i w a
ditsebeng	d i ts> E b E N
ditanka	d i t> a n k> a
katiso	k> a t> i s O
sekisa	s E k> i s a
motlhaope	m O tlh a O p> E
thaka	th a k> a
buseditswe	b u s E d i ts> w E
botlhole	b O tlh O l E
kgobokgobo	kx O b O kx O b O
thapile	th a p> i l E
gatisang	x a t> i s a N
phunyeletsang	ph u J E l E ts> a N
dumalanang	d u m a l a n a N
rotoletse	r O t> O l E ts> E
fosega	f O s E x a
nkane	n k> a n E
fapositsweng	f a p> O s i ts> w E N
boemelong	b O E m E l O N
motseletsele	m O ts> E l E ts> E l E
dikgologolo	d i kx O l O x O l O
lete	l E t> E
fosagetseng	f O s a x E ts> E N
tsogile	ts> O x i l E
dimpa	d i m p> a
ikaelela	i k> a E l E l a
edimola	E d i m O l a
makatse	m a k> a ts> E
kgolegelo	kx O l E x E l O
disekereteng	d i s E k> E r E t> E N
kolobile	k> O l O b i l E
leboge	l E b O x E
tshitasetlhoa	tsh i t> a s E tlh O a
serope	s E r O p> E
setlhagodi	s E tlh a x O d i
barutabaneng	b a r u t> a b a n E N
tshenolo	tsh E n O l O
thadisiwa	th a d i s i w a
dibekeng	d i b E k> E N
kgoreletsege	kx O r E l E ts> E x E
tshegatshega	tsh E x a tsh E x a
bokaedi	b O k> a E d i
dipatsana	d i p> a ts> a n a
bomankge	b O m a n kx E
duedisa	d u E d i s a
thulanang	th u l a n a N
diisamadi	d i i s a m a d i
boe	b O E
sekgwa	s E kx w a
matlereng	m a tl> E r E N
ipaakanyeditse	i p> a k> a J E d i ts> E
semolao	s E m O l a O
kobile	k> O b i l E
fantisi	f a n t> i s i
tekelelo	t> E k> E l E l O
amegile	a m E x i l E
repaboliking	r E p> a b O l i k> i N
araba	a r a b a
tebego	t> E b E x O
abilwe	a b i l w E
tshologileng	tsh O l O x i l E N
ntetleng	n t> E tl> E N
thibana	th i b a n a
boapei	b O a p> E i
tlhatlagantswe	tlh a tl> a x a n ts> w E
solofele	s O l O f E l E
mokato	m O k> a t> O
kgaratlha	kx a r a tlh a
nkitsitse	n k> i ts> i ts> E
kereti	k> E r E t> i
rutiwang	r u t> i w a N
thekiso	th E k> i s O
ditsamelo	d i ts> a m E l O
letlhaka	l E tlh a k> a
sejene	s E d0Z E n E
letlelele	l E tl> E l E l E
baakanyediwa	b a k> a J E d i w a
nosiweng	n O s i w E N
lekopanyi	l E k> O p> a J i
koloinyana	k> O l O i J a n a
betelelwa	b E t> E l E l w a
emiwa	E m i w a
nyadisang	J a d i s a N
ngotlegang	N O tl> E x a N
dilong	d i l O N
tlhokometswe	tlh O k> O m E ts> w E
mabota	m a b O t> a
sentse	s E n ts> E
losong	l O s O N
mabanta	m a b a n t> a
tshogile	tsh O x i l E
mmoto	m m O t> O
kukunya	k> u k> u J a
tlhomaganyong	tlh O m a x a J O N
lwetseng	l w E ts> E N
rateng	r a t> E N
gagametse	x a x a m E ts> E
popegotheong	p> O p> E x O th E O N
tlokwe	tl> O k> w E
ketelelopele	k> E t> E l E l O p> E l E
kgaogane	kx a O x a n E
ditebo	d i t> E b O
motoloki	m O t> O l O k> i
lonaka	l O n a k> a
tsamaiswa	ts> a m a i s w a
segogou	s E x O x O u
tlhomamisetsa	tlh O m a m i s E ts> a
masiela	m a s i E l a
bokolela	b O k> O l E l a
moputso	m O p> u ts> O
basading	b a s a d i N
dikagong	d i k> a x O N
dibini	d i b i n i
fokolediwa	f O k> O l E d i w a
motlhofo	m O tlh O f O
buisetsa	b u i s E ts> a
tseyeng	ts> E j E N
popego	p> O p> E x O
sefalaneng	s E f a l a n E N
tshabelang	tsh a b E l a N
laotsweng	l a O ts> w E N
utulola	u t> u l O l a
tlhaloganyeng	tlh a l O x a J E N
ipega	i p> E x a
tseelwa	ts> E E l w a
gama	x a m a
lengwa	l E N w a
modireding	m O d i r E d i N
leofa	l E O f a
kgaphetsweng	kx a ph E ts> w E N
diriwa	d i r i w a
korong	k> O r O N
bukana	b u k> a n a
ikopisa	i k> O p> i s a
golaganyeng	x O l a x a J E N
itikanyetsa	i t> i k> a J E ts> a
dikaedi	d i k> a E d i
amogetswe	a m O x E ts> w E
diriwang	d i r i w a N
tlhotlheletsa	tlh O tlh E l E ts> a
mothating	m O th a t> i N
kemiso	k> E m i s O
peomolaong	p> E O m O l a O N
ganelwe	x a n E l w E
gase	x a s E
sekwaše	s E k> w a S E
gopolang	x O p> O l a N
letsemeng	l E ts> E m E N
kgarebe	kx a r E b E
lerato	l E r a t> O
tlhanong	tlh a n O N
ithutiwang	i th u t> i w a N
gosomana	x O s O m a n a
borakgwebo	b O r a kx w E b O
kgolaganong	kx O l a x a n O N
bereka	b E r E k> a
semeto	s E m E t> O
dinaka	d i n a k> a
fokotse	f O k> O ts> E
konosetso	k> O n O s E ts> O
itimang	i t> i m a N
theilweng	th E i l w E N
ritibetseng	r i t> i b E ts> E N
nnyennyane	n J E n J a n E
thatafetse	th a t> a f E ts> E
iphetola	i ph E t> O l a
mina	m i n a
dinare	d i n a r E
tsotlhe	ts> O tlh E
iponetseng	i p> O n E ts> E N
tshetswe	tsh E ts> w E
huba	h u b a
mojakong	m O d0Z a k> O N
monning	m O n n i N
dintswa	d i n ts> w a
tlametsweng	tl> a m E ts> w E N
bommaditsela	b O m m a d i ts> E l a
polantereng	p> O l a n t> E r E N
pagololwa	p> a x O l O l w a
ngwagakgolong	N w a x a kx O l O N
gadikwa	x a d i k> w a
nkitsise	n k> i ts> i s E
selelong	s E l E l O N
bontate	b O n t> a t> E
tlhofofatsa	tlh O f O f a ts> a
tsamaiseng	ts> a m a i s E N
merabeng	m E r a b E N
bolokegile	b O l O k> E x i l E
ntho	n th O
sule	s u l E
otlhaya	O tlh a j a
tshwaragantsweng	tsh w a r a x a n ts> w E N
dirite	d i r i t> E
molwantshi	m O l w a n tsh i
fitlhileng	f i tlh i l E N
lekantsha	l E k> a n tsh a
bogolosegolo	b O x O l O s E x O l O
ititaya	i t> i t> a j a
belegwang	b E l E x w a N
letlaseng	l E tl> a s E N
hibidu	h i b i d u
emeletse	E m E l E ts> E
ditseleng	d i ts> E l E N
borobong	b O r O b O N
seboni	s E b O n i
bonwang	b O n w a N
galalelang	x a l a l E l a N
amoganwa	a m O x a n w a
dibolo	d i b O l O
tsamaisaneng	ts> a m a i s a n E N
senoto	s E n O t> O
latetswe	l a t> E ts> w E
letlametlo	l E tl> a m E tl> O
gagametseng	x a x a m E ts> E N
atlegile	a tl> E x i l E
bitswa	b i ts> w a
bonelang	b O n E l a N
nnoto	n n O t> O
kaelang	k> a E l a N
dipinagare	d i p> i n a x a r E
dipitsong	d i p> i ts> O N
ikemetseng	i k> E m E ts> E N
rerisana	r E r i s a n a
dileele	d i l E E l E
ditlhatlagano	d i tlh a tl> a x a n O
ntshetse	n tsh E ts> E
itlhalosa	i tlh a l O s a
dikereiting	d i k> E r E i t> i N
methaleng	m E th a l E N
golwane	x O l w a n E
kemelo	k> E m E l O
sekepeng	s E k> E p> E N
kgoreleditsweng	kx O r E l E d i ts> w E N
kgotlho	kx O tlh O
rekoto	r E k> O t> O
tlhotlhelediwa	tlh O tlh E l E d i w a
katoloso	k> a t> O l O s O
dikarolwaneng	d i k> a r O l w a n E N
opafatsa	O p> a f a ts> a
ijaa	i d0Z a
betsho	b E tsh O
nyelela	J E l E l a
tlhokege	tlh O k> E x E
babeeletsing	b a b E E l E ts> i N
ganang	x a n a N
motlhodi	m O tlh O d i
ditlhotlheletso	d i tlh O tlh E l E ts> O
basiamolodi	b a s i a m O l O d i
dikemo	d i k> E m O
tshepiwa	tsh E p> i w a
nkgomotse	n kx O m O ts> E
bongaka	b O N a k> a
tsupamolomo	ts> u p> a m O l O m O
solegelang	s O l E x E l a N
ikanneng	i k> a n n E N
kgaogileng	kx a O x i l E N
tlhagogileng	tlh a x O x i l E N
potlaketse	p> O tl> a k> E ts> E
itsaya	i ts> a j a
tlodilwe	tl> O d i l w E
itlhokomele	i tlh O k> O m E l E
lesedinyana	l E s E d i J a n a
baletswe	b a l E ts> w E
maitlhomomagolo	m a i tlh O m O m a x O l O
pudungwana	p> u d u N w a n a
akola	a k> O l a
dikitsiso	d i k> i ts> i s O
tlhatlega	tlh a tl> E x a
ikgolaganye	i kx O l a x a J E
gopoleng	x O p> O l E N
dipatlong	d i p> a tl> O N
sebopego	s E b O p> E x O
dikwetsa	d i k> w E ts> a
itsise	i ts> i s E
tlelorofile	tl> E l O r O f i l E
tsenyeditse	ts> E J E d i ts> E
intshwareleng	i n tsh w a r E l E N
ikgotsofatsa	i kx O ts> O f a ts> a
ikwalela	i k> w a l E l a
boagisaning	b O a x i s a n i N
moranodi	m O r a n O d i
rurifatsa	r u r i f a ts> a
latlhisiwa	l a tlh i s i w a
sotlilweng	s O tl> i l w E N
mokgwasa	m O kx w a s a
kabakanngwa	k> a b a k> a n N w a
tloso	tl> O s O
tshegetsa	tsh E x E ts> a
fofisiwa	f O f i s i w a
thusong	th u s O N
faretswe	f a r E ts> w E
patlisisong	p> a tl> i s i s O N
nnye	n J E
fetsa	f E ts> a
dileibole	d i l E i b O l E
amaneng	a m a n E N
dithapo	d i th a p> O
leelefala	l E E l E f a l a
talana	t> a l a n a
butswe	b u ts> w E
phuthologileng	ph u th O l O x i l E N
diako	d i a k> O
dikgannyeng	d i kx a n J E N
tlhaolwe	tlh a O l w E
mapalamo	m a p> a l a m O
siamang	s i a m a N
koba	k> O b a
kgatha	kx a th a
ikatiso	i k> a t> i s O
emelwa	E m E l w a
solofela	s O l O f E l a
faeleng	f a E l E N
tatofatsong	t> a t> O f a ts> O N
dithendara	d i th E n d a r a
kukana	k> u k> a n a
tshotse	tsh O ts> E
tlaletse	tl> a l E ts> E
sebokwana	s E b O k> w a n a
ditebelelo	d i t> E b E l E l O
botlhoko	b O tlh O k> O
tlhamile	tlh a m i l E
ditiriso	d i t> i r i s O
senotsididi	s E n O ts> i d i d i
bulegile	b u l E x i l E
papisong	p> a p> i s O N
bobetli	b O b E tl> i
mogokaganyi	m O x O k> a x a J i
letlhare	l E tlh a r E
kgaotso	kx a O ts> O
fetsang	f E ts> a N
umakiwa	u m a k> i w a
gokaganngwa	x O k> a x a n N w a
uba	u b a
kgotlhang	kx O tlh a N
utlwana	u tl> w a n a
meso	m E s O
itlhaloganya	i tlh a l O x a J a
itekanele	i t> E k> a n E l E
itse	i ts> E
tsositse	ts> O s i ts> E
pitlaganong	p> i tl> a x a n O N
kgogogela	kx O x O x E l a
khoso	kh O s O
segare	s E x a r E
tayari	t> a j a r i
dikgoka	d i kx O k> a
dipuisano	d i p> u i s a n O
moedi	m O E d i
itlamele	i tl> a m E l E
lebaleng	l E b a l E N
bapalami	b a p> a l a m i
tswakanyeng	ts> w a k> a J E N
dirobi	d i r O b i
mohumi	m O h u m i
bogole	b O x O l E
letlhabaphefo	l E tlh a b a ph E f O
bonetse	b O n E ts> E
huma	h u m a
ribolotse	r i b O l O ts> E
letlapeng	l E tl> a p> E N
mekoro	m E k> O r O
pitlagano	p> i tl> a x a n O
lefoko	l E f O k> O
kgatlhise	kx a tlh i s E
swetswe	s w E ts> w E
dipuisanong	d i p> u i s a n O N
dipharologantshong	d i ph a r O l O x a n tsh O N
baabelwa	b a b E l w a
maeba	m a E b a
tlhatlhelwa	tlh a tlh E l w a
molodi	m O l O d i
magwata	m a x w a t> a
bakatisi	b a k> a t> i s i
tsepame	ts> E p> a m E
tomaganyo	t> O m a x a J O
ditumanosi	d i t> u m a n O s i
bofelelo	b O f E l E l O
pitsong	p> i ts> O N
kgonwang	kx O n w a N
gabedi	x a b E d i
dikarolwana	d i k> a r O l w a n a
amiwang	a m i w a N
humiseng	h u m i s E N
duetswe	d u E ts> w E
tswaletsweng	ts> w a l E ts> w E N
tlotlomadiwa	tl> O tl> O m a d i w a
elediwa	E l E d i w a
itlhametsweng	i tlh a m E ts> w E N
tsibogo	ts> i b O x O
lobone	l O b O n E
pusetso	p> u s E ts> O
moamogedi	m O a m O x E d i
seporofešene	s E p> O r O f E S E n E
moadimi	m O a d i m i
bophologolo	b O ph O l O x O l O
tlhokafaletseng	tlh O k> a f a l E ts> E N
ratwe	r a t> w E
phuphung	ph u ph u N
lebating	l E b a t> i N
barena	b a r E n a
makeke	m a k> E k> E
angwa	a N w a
lentsi	l E n ts> i
phelela	ph E l E l a
tswalelang	ts> w a l E l a N
welang	w E l a N
amogedisa	a m O x E d i s a
totobatsa	t> O t> O b a ts> a
bokaong	b O k> a O N
ipeetse	i p> E E ts> E
sebofa	s E b O f a
mabitleng	m a b i tl> E N
poapoeletso	p> O a p> O E l E ts> O
runyang	r u J a N
ntlhalosetse	n tlh a l O s E ts> E
matlhotlhapelong	m a tlh O tlh a p> E l O N
pakiwa	p> a k> i w a
lebogela	l E b O x E l a
thibelwang	th i b E l w a N
itewa	i t> E w a
gopole	x O p> O l E
itshetlego	i tsh E tl> E x O
anamisang	a n a m i s a N
boletsweng	b O l E ts> w E N
romelwe	r O m E l w E
tlhomamisitsweng	tlh O m a m i s i ts> w E N
tumelelo	t> u m E l E l O
akarediwang	a k> a r E d i w a N
bonelwang	b O n E l w a N
lesikeng	l E s i k> E N
patelediwa	p> a t> E l E d i w a
kholomo	kh O l O m O
nnake	n n a k> E
mojadi	m O d0Z a d i
lotletsweng	l O tl> E ts> w E N
dipelaelo	d i p> E l a E l O
tsalane	ts> a l a n E
rulaganyeditswe	r u l a x a J E d i ts> w E
fokotsegang	f O k> O ts> E x a N
lebala	l E b a l a
golotsweng	x O l O ts> w E N
moketeng	m O k> E t> E N
tshwarwa	tsh w a r w a
diphasele	d i ph a s E l E
ipaakanyang	i p> a k> a J a N
atlholwe	a tlh O l w E
dikgweding	d i kx w E d i N
eme	E m E
latlhilweng	l a tlh i l w E N
tiisiwa	t> i i s i w a
tlhotlheleditse	tlh O tlh E l E d i ts> E
botemepedi	b O t> E m E p> E d i
botse	b O ts> E
kgonagalong	kx O n a x a l O N
ditlhaloso	d i tlh a l O s O
dituedisong	d i t> u E d i s O N
motopo	m O t> O p> O
dipatso	d i p> a ts> O
reediwa	r E E d i w a
mogalammakapaa	m O x a l a m m a k> a p> a
supediwa	s u p> E d i w a
ne	n E
tlhaloganyegang	tlh a l O x a J E x a N
efogang	E f O x a N
kgomaretse	kx O m a r E ts> E
sox	s O k> s
itshokelwang	i tsh O k> E l w a N
boramotse	b O r a m O ts> E
senepe	s E n E p> E
banyalani	b a J a l a n i
sekametseng	s E k> a m E ts> E N
bosomenne	b O s O m E n n E
fetisisa	f E t> i s i s a
ditlhogo	d i tlh O x O
sesala	s E s a l a
folosiwa	f O l O s i w a
anamiseng	a n a m i s E N
sosologile	s O s O l O x i l E
betile	b E t> i l E
gobatsa	x O b a ts> a
hulereng	h u l E r E N
duela	d u E l a
mangaung	m a N a u N
diakong	d i a k> O N
moetlo	m O E tl> O
tlhotlheletswang	tlh O tlh E l E ts> w a N
ditshenyo	d i tsh E J O
tlhakatlhakanngwa	tlh a k> a tlh a k> a n N w a
kgalemiwa	kx a l E m i w a
bong	b O N
kgamololo	kx a m O l O l O
thibetsweng	th i b E ts> w E N
masa	m a s a
faposa	f a p> O s a
kopololela	k> O p> O l O l E l a
lenyalong	l E J a l O N
golagana	x O l a x a n a
kgaolela	kx a O l E l a
sepeke	s E p> E k> E
mmiletsa	m m i l E ts> a
tsepama	ts> E p> a m a
maitsholomantle	m a i tsh O l O m a n tl> E
umakwang	u m a k> w a N
tshwaraganong	tsh w a r a x a n O N
phasalatso	ph a s a l a ts> O
boipelo	b O i p> E l O
loaping	l O a p> i N
bonya	b O J a
moreneng	m O r E n E N
gorositsweng	x O r O s i ts> w E N
mokgabiso	m O kx a b i s O
tlhafunwang	tlh a f u n w a N
bathapi	b a th a p> i
gata	x a t> a
direlwang	d i r E l w a N
ntsifala	n ts> i f a l a
molemirui	m O l E m i r u i
nkokoagwe	n k> O k> O a x w E
dipaakanyetso	d i p> a k> a J E ts> O
akareditseng	a k> a r E d i ts> E N
bukaneng	b u k> a n E N
fitlha	f i tlh a
moselo	m O s E l O
itebagantseng	i t> E b a x a n ts> E N
oba	O b a
bangwe	b a N w E
setlhare	s E tlh a r E
fitlhelelweng	f i tlh E l E l w E N
tsepamiso	ts> E p> a m i s O
sedibeng	s E d i b E N
pompelwa	p> O m p> E l w a
susumela	s u s u m E l a
ikitsise	i k> i ts> i s E
tshisibalo	tsh i s i b a l O
tlolwa	tl> O l w a
khutsafaditsweng	kh u ts> a f a d i ts> w E N
itshegeletsa	i tsh E x E l E ts> a
somenne	s O m E n n E
mangope	m a N O p> E
pabalelo	p> a b a l E l O
kaetsweng	k> a E ts> w E N
itlhophelang	i tlh O ph E l a N
ageleditsweng	a x E l E d i ts> w E N
etileng	E t> i l E N
mosimolodi	m O s i m O l O d i
nwetse	n w E ts> E
natefang	n a t> E f a N
merabaraba	m E r a b a r a b a
tshwailweng	tsh w a i l w E N
gamolola	x a m O l O l a
dikgannye	d i kx a n J E
tshedisa	tsh E d i s a
phuruphudiwang	ph u r u ph u d i w a N
dipeiping	d i p> E i p> i N
phuthologang	ph u th O l O x a N
dirobe	d i r O b E
ikgoga	i kx O x a
boipobolo	b O i p> O b O l O
solofetseng	s O l O f E ts> E N
bonatla	b O n a tl> a
kgolofalo	kx O l O f a l O
bokwadisetsong	b O k> w a d i s E ts> O N
ditsie	d i ts> i E
moribo	m O r i b O
rulaganyetsa	r u l a x a J E ts> a
sethabeng	s E th a b E N
akareditsweng	a k> a r E d i ts> w E N
bodirisi	b O d i r i s i
batlisisang	b a tl> i s i s a N
ngwaong	N w a O N
kwana	k> w a n a
lekgotlatoropo	l E kx O tl> a t> O r O p> O
monyenyo	m O J E J O
kgatlhisitse	kx a tlh i s i ts> E
tlhokafetseng	tlh O k> a f E ts> E N
sekgemetšhane	s E kx E m E tSh a n E
tlhadilweng	tlh a d i l w E N
itumedise	i t> u m E d i s E
ipatelediwang	i p> a t> E l E d i w a N
inyalelang	i J a l E l a N
tlhasetse	tlh a s E ts> E
begele	b E x E l E
tshegofala	tsh E x O f a l a
tlhagisang	tlh a x i s a N
futswela	f u ts> w E l a
dialemanaka	d i a l E m a n a k> a
tlhago	tlh a x O
fatolaka	f a t> O l a k> a
atisiwa	a t> i s i w a
magodu	m a x O d u
monawa	m O n a w a
buisetswa	b u i s E ts> w a
itlhalosang	i tlh a l O s a N
ngwanaitseele	N w a n a i ts> E E l E
kgantelenyana	kx a n t> E l E J a n a
sekere	s E k> E r E
botsaya	b O ts> a j a
tlhokego	tlh O k> E x O
botsamaisi	b O ts> a m a i s i
phasaladiwe	ph a s a l a d i w E
sepotlana	s E p> O tl> a n a
bonkoko	b O n k> O k> O
akgwa	a kx w a
boikwadiso	b O i k> w a d i s O
timeditse	t> i m E d i ts> E
lemoge	l E m O x E
morekisi	m O r E k> i s i
alafegeng	a l a f E x E N
mosetsaneng	m O s E ts> a n E N
utlwetse	u tl> w E ts> E
phetelela	ph E t> E l E l a
robegileng	r O b E x i l E N
tebong	t> E b O N
ntlhanyana	n tlh a J a n a
ngatana	N a t> a n a
phisegelo	ph i s E x E l O
fetiseditsweng	f E t> i s E d i ts> w E N
alela	a l E l a
mokorong	m O k> O r O N
kopilweng	k> O p> i l w E N
tlhomamisitse	tlh O m a m i s i ts> E
tsepamisiwa	ts> E p> a m i s i w a
bolokelang	b O l O k> E l a N
dingwedi	d i N w E d i
tokafala	t> O k> a f a l a
tokafalang	t> O k> a f a l a N
lekgethong	l E kx E th O N
lorole	l O r O l E
ikgateng	i kx a t> E N
natefetswe	n a t> E f E ts> w E
beseng	b E s E N
yong	j O N
mesola	m E s O l a
afe	a f E
seduting	s E d u t> i N
sikarang	s i k> a r a N
alafiwe	a l a f i w E
amogilweng	a m O x i l w E N
tshupamolatong	tsh u p> a m O l a t> O N
meraro	m E r a r O
sebi	s E b i
nthate	n th a t> E
etelela	E t> E l E l a
dikgotlatshekelong	d i kx O tl> a tsh E k> E l O N
tulong	t> u l O N
lelefatseng	l E l E f a ts> E N
kgatlhegong	kx a tlh E x O N
dinkung	d i n k> u N
kgaratlhelo	kx a r a tlh E l O
khukhutha	kh u kh u th a
kikimere	k> i k> i m E r E
hutshe	h u tsh E
kgobalo	kx O b a l O
barwa	b a r w a
sokotse	s O k> O ts> E
kgobokong	kx O b O k> O N
ntšhotšho	n tSh O tSh O
atologileng	a t> O l O x i l E N
dikgannyaneng	d i kx a n J a n E N
teye	t> E j E
tlhokegong	tlh O k> E x O N
ntshitsweng	n tsh i ts> w E N
maele	m a E l E
batle	b a tl> E
ntshwafatsa	n tsh w a f a ts> a
duelwa	d u E l w a
magadimana	m a x a d i m a n a
mokgaphe	m O kx a ph E
nyemisa	J E m i s a
mmonang	m m O n a N
tswalang	ts> w a l a N
bagaabo	b a x a b O
tlhapile	tlh a p> i l E
godisetswa	x O d i s E ts> w a
boenjeniri	b O E n d0Z E n i r i
iphetsang	i ph E ts> a N
sekhutlwana	s E kh u tl> w a n a
phutho	ph u th O
ileditswe	i l E d i ts> w E
palela	p> a l E l a
atlega	a tl> E x a
bofiwang	b O f i w a N
dibui	d i b u i
boelwa	b O E l w a
tlhongwe	tlh O N w E
hutara	h u t> a r a
sesepa	s E s E p> a
sotlilwe	s O tl> i l w E
thunyang	th u J a N
betwang	b E t> w a N
balemisi	b a l E m i s i
komano	k> O m a n O
tlhalosegeng	tlh a l O s E x E N
itseye	i ts> E j E
galefisitse	x a l E f i s i ts> E
tonanyana	t> O n a J a n a
tlotlana	tl> O tl> a n a
loboteng	l O b O t> E N
sefofu	s E f O f u
kgano	kx a n O
kgwanyape	kx w a J a p> E
makopanyi	m a k> O p> a J i
maikanong	m a i k> a n O N
itlhophele	i tlh O ph E l E
selefera	s E l E f E r a
bokgoba	b O kx O b a
ikgomaretsang	i kx O m a r E ts> a N
dituediso	d i t> u E d i s O
phiketa	ph i k> E t> a
sepalangwa	s E p> a l a N w a
iponagatsa	i p> O n a x a ts> a
arogantseng	a r O x a n ts> E N
gagwe	x a x w E
merafeng	m E r a f E N
tlotlego	tl> O tl> E x O
diphiri	d i ph i r i
latelwa	l a t> E l w a
diboutu	d i b O u t> u
sikeng	s i k> E N
ntlogetse	n tl> O x E ts> E
lekgetlho	l E kx E tlh O
mokgobe	m O kx O b E
iponela	i p> O n E l a
utswa	u ts> w a
kadimong	k> a d i m O N
lwantsheng	l w a n tsh E N
lebentlele	l E b E n tl> E l E
tsamaelane	ts> a m a E l a n E
kala	k> a l a
jesa	d0Z E s a
tefo	t> E f O
botegeniki	b O t> E x E n i k> i
makgating	m a kx a t> i N
dinagamagaeng	d i n a x a m a x a E N
kgakolwa	kx a k> O l w a
rraagwemogolo	r r a x w E m O x O l O
pharologantsho	ph a r O l O x a n tsh O
molemiruing	m O l E m i r u i N
makolwane	m a k> O l w a n E
bofolola	b O f O l O l a
diretseng	d i r E ts> E N
komititsamaiso	k> O m i t> i ts> a m a i s O
jaa	d0Z a
dikgannyana	d i kx a n J a n a
kaelo	k> a E l O
omanwa	O m a n w a
boelediwa	b O E l E d i w a
sethalwa	s E th a l w a
tokololong	t> O k> O l O l O N
ditleloko	d i tl> E l O k> O
dikopong	d i k> O p> O N
motšhine	m O tSh i n E
nniwa	n n i w a
nyadisitswe	J a d i s i ts> w E
batlhankedi	b a tlh a n k> E d i
putla	p> u tl> a
fulang	f u l a N
gabileng	x a b i l E N
fetisiwe	f E t> i s i w E
kwalolola	k> w a l O l O l a
tshotlego	tsh O tl> E x O
kgodumodumo	kx O d u m O d u m O
amogelesega	a m O x E l E s E x a
diraneng	d i r a n E N
diromelwantle	d i r O m E l w a n tl> E
dintšhafatso	d i n tSh a f a ts> O
itomile	i t> O m i l E
amanang	a m a n a N
dipala	d i p> a l a
siamisiwe	s i a m i s i w E
dibeke	d i b E k> E
palelwa	p> a l E l w a
kgofa	kx O f a
dikadika	d i k> a d i k> a
loagong	l O a x O N
tshosediwa	tsh O s E d i w a
dibaka	d i b a k> a
botlhabatsatsi	b O tlh a b a ts> a ts> i
ditema	d i t> E m a
boitiriso	b O i t> i r i s O
tloge	tl> O x E
ritibetse	r i t> i b E ts> E
itlhophela	i tlh O ph E l a
rekegelang	r E k> E x E l a N
botsididi	b O ts> i d i d i
boikaego	b O i k> a E x O
tonakgolo	t> O n a kx O l O
bomenemene	b O m E n E m E n E
mabele	m a b E l E
mmoping	m m O p> i N
anelwa	a n E l w a
nkgelela	n kx E l E l a
tlatseng	tl> a ts> E N
fetoleleng	f E t> O l E l E N
tswela	ts> w E l a
seatla	s E a tl> a
latlhegile	l a tlh E x i l E
boitlosobodutu	b O i tl> O s O b O d u t> u
kgoreletsang	kx O r E l E ts> a N
beola	b E O l a
bosona	b O s O n a
katisa	k> a t> i s a
setlhongwa	s E tlh O N w a
tlhagang	tlh a x a N
tshegofaditswe	tsh E x O f a d i ts> w E
opelwa	O p> E l w a
tshiamo	tsh i a m O
dinala	d i n a l a
dikgweng	d i kx w E N
serodumo	s E r O d u m O
lekanyetseng	l E k> a J E ts> E N
rora	r O r a
kgobegileng	kx O b E x i l E N
dinoka	d i n O k> a
selepe	s E l E p> E
tiragalong	t> i r a x a l O N
fetlhwa	f E tlh w a
moemeding	m O E m E d i N
gaisaneng	x a i s a n E N
malobanyana	m a l O b a J a n a
monyelang	m O J E l a N
batlisisiwe	b a tl> i s i s i w E
boditsweng	b O d i ts> w E N
mokhura	m O kh u r a
tshololela	tsh O l O l E l a
sediriso	s E d i r i s O
poloko	p> O l O k> O
rapame	r a p> a m E
tshwaregang	tsh w a r E x a N
lefeelo	l E f E E l O
ditshika	d i tsh i k> a
senka	s E n k> a
sailang	s a i l a N
dikeletsong	d i k> E l E ts> O N
felele	f E l E l E
dintelo	d i n t> E l O
olela	O l E l a
dikgapetla	d i kx a p> E tl> a
fetisetsa	f E t> i s E ts> a
duleng	d u l E N
falotseng	f a l O ts> E N
itekanetse	i t> E k> a n E ts> E
patelesego	p> a t> E l E s E x O
fetolelwang	f E t> O l E l w a N
nakwana	n a k> w a n a
setlhakatlhakeng	s E tlh a k> a tlh a k> E N
serwalo	s E r w a l O
totilwe	t> O t> i l w E
golega	x O l E x a
fetogetse	f E t> O x E ts> E
tlanyang	tl> a J a N
senthara	s E n th a r a
bosigong	b O s i x O N
dipuodintsi	d i p> u O d i n ts> i
supe	s u p> E
popomaditsweng	p> O p> O m a d i ts> w E N
naso	n a s O
lorile	l O r i l E
lekantswe	l E k> a n ts> w E
njela	n d0Z E l a
tshireletsego	tsh i r E l E ts> E x O
ralatsa	r a l a ts> a
tswelediwe	ts> w E l E d i w E
tlogedisa	tl> O x E d i s a
dipolelwana	d i p> O l E l w a n a
lwang	l w a N
merataro	m E r a t> a r O
bomagiseterata	b O m a x i s E t> E r a t> a
atileng	a t> i l E N
phatšhegela	ph a tSh E x E l a
robegile	r O b E x i l E
emelelanang	E m E l E l a n a N
aparwa	a p> a r w a
eteleleng	E t> E l E l E N
ketelo	k> E t> E l O
diphuthelwana	d i ph u th E l w a n a
tlhophilwe	tlh O ph i l w E
motlhoki	m O tlh O k> i
thutapalo	th u t> a p> a l O
mogoma	m O x O m a
nao	n a O
metona	m E t> O n a
setlisamadi	s E tl> i s a m a d i
segotlholo	s E x O tlh O l O
balege	b a l E x E
dikonyana	d i k> O J a n a
phoso	ph O s O
itumelelang	i t> u m E l E l a N
dithibedi	d i th i b E d i
dimpanyana	d i m p> a J a n a
senyegang	s E J E x a N
tlholetsweng	tlh O l E ts> w E N
kgasong	kx a s O N
hemela	h E m E l a
gorogile	x O r O x i l E
leditse	l E d i ts> E
sekgoropa	s E kx O r O p> a
moeti	m O E t> i
letshoroma	l E tsh O r O m a
tharing	th a r i N
tsholetsang	tsh O l E ts> a N
leketlhang	l E k> E tlh a N
lomaganya	l O m a x a J a
mausausa	m a u s a u s a
bakwaledi	b a k> w a l E d i
ngokiwa	N O k> i w a
nngwe	n N w E
ikuela	i k> u E l a
itsamaisa	i ts> a m a i s a
farologantsha	f a r O l O x a n tsh a
atlegileng	a tl> E x i l E N
dikete	d i k> E t> E
dikuranta	d i k> u r a n t> a
poela	p> O E l a
kgomong	kx O m O N
kgaoganweng	kx a O x a n w E N
tliseditseng	tl> i s E d i ts> E N
dikamore	d i k> a m O r E
retelelwa	r E t> E l E l w a
itlhalose	i tlh a l O s E
kopile	k> O p> i l E
mmogo	m m O x O
mogwebing	m O x w E b i N
boitsholong	b O i tsh O l O N
goleele	x O l E E l E
dibako	d i b a k> O
dibotlolo	d i b O tl> O l O
batlotlegi	b a tl> O tl> E x i
sehuba	s E h u b a
karolotuelo	k> a r O l O t> u E l O
dirile	d i r i l E
kgethololeng	kx E th O l O l E N
madirelong	m a d i r E l O N
diporo	d i p> O r O
banta	b a n t> a
bopodi	b O p> O d i
ditshireletsego	d i tsh i r E l E ts> E x O
tagang	t> a x a N
belegetsweng	b E l E x E ts> w E N
sekhoi	s E kh O i
direferentamo	d i r E f E r E n t> a m O
nomorong	n O m O r O N
sekasekiwe	s E k> a s E k> i w E
boruma	b O r u m a
dikeletso	d i k> E l E ts> O
rapama	r a p> a m a
fapa	f a p> a
dibokosong	d i b O k> O s O N
pagameng	p> a x a m E N
sephuthelwana	s E ph u th E l w a n a
letsatsi	l E ts> a ts> i
kopolola	k> O p> O l O l a
phatsima	ph a ts> i m a
kgetho	kx E th O
sebuisegolo	s E b u i s E x O l O
swe	s w E
ditšheke	d i tSh E k> E
lepololwa	l E p> O l O l w a
seriting	s E r i t> i N
mosong	m O s O N
ipatlela	i p> a tl> E l a
borotho	b O r O th O
tsadisong	ts> a d i s O N
dibete	d i b E t> E
mmamoso	m m a m O s O
foo	f O O
silegileng	s i l E x i l E N
solofetse	s O l O f E ts> E
noko	n O k> O
phousetara	ph O u s E t> a r a
bokalo	b O k> a l O
tlhobosa	tlh O b O s a
ikaketsa	i k> a k> E ts> a
difaleng	d i f a l E N
solegele	s O l E x E l E
fepiwang	f E p> i w a N
dišawara	d i S a w a r a
gokagantsweng	x O k> a x a n ts> w E N
gagamadiwa	x a x a m a d i w a
theogetseng	th E O x E ts> E N
ditlhokego	d i tlh O k> E x O
simolotseng	s i m O l O ts> E N
ganana	x a n a n a
tshwanetse	tsh w a n E ts> E
matlakadibe	m a tl> a k> a d i b E
bothitho	b O th i th O
ntha	n th a
lekileng	l E k> i l E N
ditebogo	d i t> E b O x O
thotamadi	th O t> a m a d i
pinki	p> i n k> i
tsere	ts> E r E
ntlhaneng	n tlh a n E N
rurifaditsweng	r u r i f a d i ts> w E N
tshwaraganyo	tsh w a r a x a J O
khosong	kh O s O N
matlhogonolo	m a tlh O x O n O l O
mokgwaro	m O kx w a r O
obametswe	O b a m E ts> w E
khidiega	kh i d i E x a
boima	b O i m a
nesa	n E s a
phika	ph i k> a
diakhaefeng	d i a kh a E f E N
sukiring	s u k> i r i N
mefutakwalo	m E f u t> a k> w a l O
bokaedibogolo	b O k> a E d i b O x O l O
itlhaloganyang	i tlh a l O x a J a N
khuduso	kh u d u s O
solofelang	s O l O f E l a N
gobelelwang	x O b E l E l w a N
sikologe	s i k> O l O x E
kokoanopeomolaong	k> O k> O a n O p> E O m O l a O N
lekgotla	l E kx O tl> a
makwalotetla	m a k> w a l O t> E tl> a
lelelweng	l E l E l w E N
dibeteri	d i b E t> E r i
amogelegeng	a m O x E l E x E N
motshwaramarapo	m O tsh w a r a m a r a p> O
moakanyetsi	m O a k> a J E ts> i
tshwenyanang	tsh w E J a n a N
mabokoboko	m a b O k> O b O k> O
itlhamelang	i tlh a m E l a N
tukang	t> u k> a N
sotliwa	s O tl> i w a
manyalo	m a J a l O
kopiwang	k> O p> i w a N
somarelwa	s O m a r E l w a
letamo	l E t> a m O
makgotlatoropong	m a kx O tl> a t> O r O p> O N
phasaladitsweng	ph a s a l a d i ts> w E N
bagaeno	b a x a E n O
tlhologelelo	tlh O l O x E l E l O
jetse	d0Z E ts> E
gasitsweng	x a s i ts> w E N
setelwang	s E t> E l w a N
kgatlhegelo	kx a tlh E x E l O
leteng	l E t> E N
tekatekanong	t> E k> a t> E k> a n O N
tshwaileng	tsh w a i l E N
kgosomano	kx O s O m a n O
metlha	m E tlh a
senoga	s E n O x a
letsatsing	l E ts> a ts> i N
bagolegwa	b a x O l E x w a
kgatlhwe	kx a tlh w E
semelela	s E m E l E l a
khurumetse	kh u r u m E ts> E
selomelakobong	s E l O m E l a k> O b O N
tlhakisa	tlh a k> i s a
dikgetsing	d i kx E ts> i N
dikgwebisano	d i kx w E b i s a n O
dithotong	d i th O t> O N
dumelang	d u m E l a N
temo	t> E m O
boeletse	b O E l E ts> E
lotolotsa	l O t> O l O ts> a
gapelesegang	x a p> E l E s E x a N
kolotiwang	k> O l O t> i w a N
ditshebong	d i tsh E b O N
tuedisong	t> u E d i s O N
botlhaswa	b O tlh a s w a
bilediwa	b i l E d i w a
tlhophileng	tlh O ph i l E N
mametlelelong	m a m E tl> E l E l O N
kgetsaneng	kx E ts> a n E N
motswakwa	m O ts> w a k> w a
setsholwa	s E tsh O l w a
baipeing	b a i p> E i N
kgabagantseng	kx a b a x a n ts> E N
nyalanyo	J a l a J O
ditshetlha	d i tsh E tlh a
robetse	r O b E ts> E
bogotlheng	b O x O tlh E N
seduti	s E d u t> i
diretsweng	d i r E ts> w E N
bonako	b O n a k> O
tshwenye	tsh w E J E
keresemose	k> E r E s E m O s E
golofetseng	x O l O f E ts> E N
tshosetse	tsh O s E ts> E
boraro	b O r a r O
sefetisi	s E f E t> i s i
dikgatelelo	d i kx a t> E l E l O
latlhelang	l a tlh E l a N
kobilweng	k> O b i l w E N
itsa	i ts> a
opafatso	O p> a f a ts> O
tšhese	tSh E s E
ditlhobaelo	d i tlh O b a E l O
kereiti	k> E r E i t> i
phisegelong	ph i s E x E l O N
tshosediwang	tsh O s E d i w a N
ratang	r a t> a N
mosadimogolo	m O s a d i m O x O l O
motshwanedi	m O tsh w a n E d i
badiring	b a d i r i N
peomelao	p> E O m E l a O
tlhametsweng	tlh a m E ts> w E N
keledi	k> E l E d i
boagisanyi	b O a x i s a J i
utlwela	u tl> w E l a
dikampa	d i k> a m p> a
lotlelwa	l O tl> E l w a
tlhokagale	tlh O k> a x a l E
setlhabelo	s E tlh a b E l O
legonnyana	l E x O n J a n a
ikapesa	i k> a p> E s a
tselang	ts> E l a N
ntlhaba	n tlh a b a
tshabelelwa	tsh a b E l E l w a
beelwe	b E E l w E
ditokana	d i t> O k> a n a
gorosiwang	x O r O s i w a N
latelanya	l a t> E l a J a
mafega	m a f E x a
basimolodi	b a s i m O l O d i
moopedisi	m O O p> E d i s i
tatelelo	t> a t> E l E l O
kwalwa	k> w a l w a
rafa	r a f a
malokong	m a l O k> O N
binwa	b i n w a
dikgobelelo	d i kx O b E l E l O
latofatsa	l a t> O f a ts> a
kwadi	k> w a d i
tlhalosong	tlh a l O s O N
alefabete	a l E f a b E t> E
felela	f E l E l a
tsweleditsweng	ts> w E l E d i ts> w E N
thubana	th u b a n a
anamise	a n a m i s E
setsweng	s E ts> w E N
farologane	f a r O l O x a n E
kgadiepetso	kx a d i E p> E ts> O
sengweng	s E N w E N
lekwete	l E k> w E t> E
dikhampase	d i kh a m p> a s E
motshamekong	m O tsh a m E k> O N
utlwagalang	u tl> w a x a l a N
ipipa	i p> i p> a
tshamekiwa	tsh a m E k> i w a
amogelang	a m O x E l a N
botsheganaingate	b O tsh E x a n a i N a t> E
phunya	ph u J a
tlhokomelela	tlh O k> O m E l E l a
ikonoming	i k> O n O m i N
morwa	m O r w a
motimedi	m O t> i m E d i
ngamoga	N a m O x a
bathei	b a th E i
boatlhamo	b O a tlh a m O
makwalokopo	m a k> w a l O k> O p> O
mmoloke	m m O l O k> E
poelano	p> O E l a n O
atametseng	a t> a m E ts> E N
mofuteng	m O f u t> E N
kgaoganngwe	kx a O x a n N w E
ratoropo	r a t> O r O p> O
latlhwa	l a tlh w a
setlapele	s E tl> a p> E l E
balwetsi	b a l w E ts> i
segatsetsing	s E x a ts> E ts> i N
