bogolobogolo	b O x O l O b O x O l O
bosone	b O s O n E
itshupe	i tsh u p> E
ithaopela	i th a O p> E l a
rekelwa	r E k> E l w a
semeletseng	s E m E l E ts> E N
setlhong	s E tlh O N
amilwe	a m i l w E
tloga	tl> O x a
saletsweng	s a l E ts> w E N
itlhophetsweng	i tlh O ph E ts> w E N
fetisetsang	f E t> i s E ts> a N
motswere	m O ts> w E r E
dikhemisi	d i kh E m i s i
bofelo	b O f E l O
lelokong	l E l O k> O N
gasiwa	x a s i w a
tliliniki	tl> i l i n i k> i
ditshimega	d i tsh i m E x a
botlapele	b O tl> a p> E l E
sankatane	s a n k> a t> a n E
kwadisang	k> w a d i s a N
bodiri	b O d i r i
tshupetso	tsh u p> E ts> O
reetsa	r E E ts> a
tswalwe	ts> w a l w E
tlhajwa	tlh a d0Z w a
mokoto	m O k> O t> O
tlhoka	tlh O k> a
neeleng	n E E l E N
akanngwe	a k> a n N w E
kaileng	k> a i l E N
thapiwa	th a p> i w a
bopagana	b O p> a x a n a
gantsinyana	x a n ts> i J a n a
khutshwafatsa	kh u tsh w a f a ts> a
sethitho	s E th i th O
dipoelothutong	d i p> O E l O th u t> O N
bogelang	b O x E l a N
masedi	m a s E d i
kamogano	k> a m O x a n O
moabi	m O a b i
tswelelapele	ts> w E l E l a p> E l E
kgotleng	kx O tl> E N
godisiwang	x O d i s i w a N
totisitswe	t> O t> i s i ts> w E
jalela	d0Z a l E l a
tiise	t> i i s E
merokotso	m E r O k> O ts> O
tlhokola	tlh O k> O l a
matlhabelo	m a tlh a b E l O
dithaere	d i th a E r E
tselakhutshwane	ts> E l a kh u tsh w a n E
mofenyi	m O f E J i
mapo	m a p> O
tlhabologileng	tlh a b O l O x i l E N
roromela	r O r O m E l a
dikaratana	d i k> a r a t> a n a
mosekaseki	m O s E k> a s E k> i
kanama	k> a n a m a
makapi	m a k> a p> i
sethong	s E th O N
tsile	ts> i l E
baakanyang	b a k> a J a N
fokotsegeng	f O k> O ts> E x E N
lekanela	l E k> a n E l a
diphaposiborutelo	d i ph a p> O s i b O r u t> E l O
palotlase	p> a l O tl> a s E
gatwa	x a t> w a
dijanageng	d i d0Z a n a x E N
batlatsamodulasetulo	b a tl> a ts> a m O d u l a s E t> u l O
phuthiwa	ph u th i w a
itlhophileng	i tlh O ph i l E N
ikana	i k> a n a
motswasetlhabelo	m O ts> w a s E tlh a b E l O
futshe	f u tsh E
tlholana	tlh O l a n a
manaka	m a n a k> a
batlelwang	b a tl> E l w a N
tsweleletse	ts> w E l E l E ts> E
pheuga	ph E u x a
eteletse	E t> E l E ts> E
tsholong	tsh O l O N
dintho	d i n th O
dinyane	d i J a n E
serolwana	s E r O l w a n a
selei	s E l E i
baemedi	b a E m E d i
thuno	th u n O
bomatlhogole	b O m a tlh O x O l E
itsholelang	i tsh O l E l a N
diphatlhatiro	d i ph a tlh a t> i r O
mafulong	m a f u l O N
kgotlhelang	kx O tlh E l a N
lerumo	l E r u m O
beelwa	b E E l w a
abetseng	a b E ts> E N
maano	m a a n O
dithateng	d i th a t> E N
bolokilwe	b O l O k> i l w E
tsaleng	ts> a l E N
tshosetsa	tsh O s E ts> a
phasaladitseng	ph a s a l a d i ts> E N
patelediwang	p> a t> E l E d i w a N
tlotlomadiwang	tl> O tl> O m a d i w a N
reteletswe	r E t> E l E ts> w E
sutlhe	s u tlh E
lerama	l E r a m a
mosimeng	m O s i m E N
motloutlo	m O tl> O u tl> O
tlhatlhobeng	tlh a tlh O b E N
maphuka	m a ph u k> a
kwaletswe	k> w a l E ts> w E
ikgobatsa	i kx O b a ts> a
maitsegotlhe	m a i ts> E x O tlh E
tlhoileng	tlh O i l E N
busediweng	b u s E d i w E N
kgatlhegile	kx a tlh E x i l E
diphotlwa	d i ph O tl> w a
dinomoro	d i n O m O r O
dipoo	d i p> O O
neetsweng	n E E ts> w E N
ntsi	n ts> i
ripotong	r i p> O t> O N
tlhalane	tlh a l a n E
lotlela	l O tl> E l a
gagasela	x a x a s E l a
oo	O O
motlhaba	m O tlh a b a
dithekiso	d i th E k> i s O
eletse	E l E ts> E
nyeletso	J E l E ts> O
fofang	f O f a N
goeleditswe	x O E l E d i ts> w E
kgwaritsakgwaritsa	kx w a r i ts> a kx w a r i ts> a
setlhobogwa	s E tlh O b O x w a
tlhatlhamanong	tlh a tlh a m a n O N
mabaleng	m a b a l E N
phetsega	ph E ts> E x a
tlhalosiweng	tlh a l O s i w E N
thanolelo	th a n O l E l O
motlhadiwa	m O tlh a d i w a
kgethisiwang	kx E th i s i w a N
melaotlhomo	m E l a O tlh O m O
baatlhodisi	b a tlh O d i s i
diphilo	d i ph i l O
tlwaelong	tl> w a E l O N
alafiwa	a l a f i w a
kharikhulamo	kh a r i kh u l a m O
maithamako	m a i th a m a k> O
dikobong	d i k> O b O N
tshamekele	tsh a m E k> E l E
kopanetsweng	k> O p> a n E ts> w E N
tlhaolosa	tlh a O l O s a
bojosi	b O d0Z O s i
sutlhelela	s u tlh E l E l a
itsisitswe	i ts> i s i ts> w E
moikueding	m O i k> u E d i N
moenjenere	m O E n d0Z E n E r E
bogammana	b O x a m m a n a
logediwa	l O x E d i w a
ditsiabadimo	d i ts> i a b a d i m O
bapisiwang	b a p> i s i w a N
tlhameng	tlh a m E N
tlhaolegileng	tlh a O l E x i l E N
ditshenekeging	d i tsh E n E k> E x i N
botlhatswetsong	b O tlh a ts> w E ts> O N
sera	s E r a
leša	l E S a
tshekeletsa	tsh E k> E l E ts> a
maphatamabedi	m a ph a t> a m a b E d i
ela	E l a
ntate	n t> a t> E
gapa	x a p> a
letshogo	l E tsh O x O
ipaakanye	i p> a k> a J E
kopiwa	k> O p> i w a
tlhatlagano	tlh a tl> a x a n O
etseng	E ts> E N
tshalelo	tsh a l E l O
botsayakarolong	b O ts> a j a k> a r O l O N
diroto	d i r O t> O
tsiboga	ts> i b O x a
letliwang	l E tl> i w a N
ntlhakgolo	n tlh a kx O l O
pepeneneng	p> E p> E n E n E N
imelwa	i m E l w a
kgokgotso	kx O kx O ts> O
tshitshinyo	tsh i tsh i J O
kgaoganwang	kx a O x a n w a N
tlhogo	tlh O x O
lenyora	l E J O r a
tlamelang	tl> a m E l a N
tshwantsha	tsh w a n tsh a
amogelwang	a m O x E l w a N
keletso	k> E l E ts> O
gamiwa	x a m i w a
alafelwa	a l a f E l w a
nyetswe	J E ts> w E
tshweetsong	tsh w E E ts> O N
kgoreletsega	kx O r E l E ts> E x a
tokafalo	t> O k> a f a l O
meta	m E t> a
itidimaletse	i t> i d i m a l E ts> E
mogwebi	m O x w E b i
isagong	i s a x O N
tshwaetsang	tsh w a E ts> a N
rantao	r a n t> a O
namane	n a m a n E
senonnori	s E n O n n O r i
logilweng	l O x i l w E N
kgodiso	kx O d i s O
bofegile	b O f E x i l E
borweng	b O r w E N
moja	m O d0Z a
karolwaneng	k> a r O l w a n E N
sitisa	s i t> i s a
tlhakanela	tlh a k> a n E l a
batlwang	b a tl> w a N
mangapo	m a N a p> O
botong	b O t> O N
reketlang	r E k> E tl> a N
fapogele	f a p> O x E l E
tlamelelwang	tl> a m E l E l w a N
ngangisanang	N a N i s a n a N
bakomisinara	b a k> O m i s i n a r a
tlhomiwang	tlh O m i w a N
etegelang	E t> E x E l a N
sekama	s E k> a m a
tshebi	tsh E b i
tlhabolotsweng	tlh a b O l O ts> w E N
ntumela	n t> u m E l a
idibetseng	i d i b E ts> E N
kgalalelong	kx a l a l E l O N
phimoga	ph i m O x a
kgono	kx O n O
sisibetse	s i s i b E ts> E
nnotagi	n n O t> a x i
kailwe	k> a i l w E
ijela	i d0Z E l a
tswelopele	ts> w E l O p> E l E
gorosa	x O r O s a
molwetse	m O l w E ts> E
kgoreleditse	kx O r E l E d i ts> E
dimakasine	d i m a k> a s i n E
tekano	t> E k> a n O
fentse	f E n ts> E
reng	r E N
heelang	h E E l a N
mmatlang	m m a tl> a N
ditšhesele	d i tSh E s E l E
batswasetlhabelong	b a ts> w a s E tlh a b E l O N
boloka	b O l O k> a
itsetletse	i ts> E tl> E ts> E
temana	t> E m a n a
loga	l O x a
tlelang	tl> E l a N
didimala	d i d i m a l a
magweregwere	m a x w E r E x w E r E
tiisitse	t> i i s i ts> E
betlang	b E tl> a N
thubego	th u b E x O
dumelaneng	d u m E l a n E N
gona	x O n a
tshwantshanngwang	tsh w a n tsh a n N w a N
jole	d0Z O l E
motlholo	m O tlh O l O
tshele	tsh E l E
bolawe	b O l a w E
mmetse	m m E ts> E
pudulo	p> u d u l O
sedumedi	s E d u m E d i
itsholela	i tsh O l E l a
dirisanang	d i r i s a n a N
fitlhelega	f i tlh E l E x a
belegelwa	b E l E x E l w a
botlhokakitso	b O tlh O k> a k> i ts> O
phatleng	ph a tl> E N
kgotsofatseng	kx O ts> O f a ts> E N
mmaabo	m m a b O
baakanngwe	b a k> a n N w E
lekhutshwane	l E kh u tsh w a n E
tsepa	ts> E p> a
tlharaletseng	tlh a r a l E ts> E N
matantabelo	m a t> a n t> a b E l O
tlhokometse	tlh O k> O m E ts> E
temogo	t> E m O x O
mabelong	m a b E l O N
dipoeletso	d i p> O E l E ts> O
balelwang	b a l E l w a N
motlokolo	m O tl> O k> O l O
rebolelwang	r E b O l E l w a N
loisiwa	l O i s i w a
tsetseng	ts> E ts> E N
tlhoname	tlh O n a m E
sejwalo	s E d0Z w a l O
moemedi	m O E m E d i
ngadile	N a d i l E
thelwa	th E l w a
mpeng	m p> E N
loilwe	l O i l w E
bonolonyana	b O n O l O J a n a
tlhatlaganyo	tlh a tl> a x a J O
gogelwa	x O x E l w a
nyalwe	J a l w E
nthusitse	n th u s i ts> E
letlapa	l E tl> a p> a
sweditseng	s w E d i ts> E N
seletswa	s E l E ts> w a
pakilwe	p> a k> i l w E
tsholetso	tsh O l E ts> O
tomaganong	t> O m a x a n O N
kgaitsadiaka	kx a i ts> a d i a k> a
maesimane	m a E s i m a n E
dikamanong	d i k> a m a n O N
dueletseng	d u E l E ts> E N
dikomiting	d i k> O m i t> i N
dipapetla	d i p> a p> E tl> a
bofelong	b O f E l O N
fetofetotswe	f E t> O f E t> O ts> w E
tsibosang	ts> i b O s a N
otlhaiwe	O tlh a i w E
buisanwa	b u i s a n w a
boitaolo	b O i t> a O l O
tshisintsweng	tsh i s i n ts> w E N
phanya	ph a J a
kgotlatheomolaong	kx O tl> a th E O m O l a O N
robegetseng	r O b E x E ts> E N
bontshang	b O n tsh a N
tlwaelega	tl> w a E l E x a
leseka	l E s E k> a
diegisitsweng	d i E x i s i ts> w E N
ipofile	i p> O f i l E
tsosiwa	ts> O s i w a
mokaeding	m O k> a E d i N
dikolong	d i k> O l O N
hisetoring	h i s E t> O r i N
kopakopana	k> O p> a k> O p> a n a
diketekete	d i k> E t> E k> E t> E
magaeng	m a x a E N
tlaleletsa	tl> a l E l E ts> a
bojelo	b O d0Z E l O
ikhutseng	i kh u ts> E N
dikunong	d i k> u n O N
thaiwa	th a i w a
gotsa	x O ts> a
kaega	k> a E x a
sarasara	s a r a s a r a
dipitseng	d i p> i ts> E N
gamela	x a m E l a
bolokwe	b O l O k> w E
tsentseng	ts> E n ts> E N
sengwagapedi	s E N w a x a p> E d i
pheleng	ph E l E N
ikwadiseditse	i k> w a d i s E d i ts> E
phanyegile	ph a J E x i l E
mabedi	m a b E d i
mmalwa	m m a l w a
itlame	i tl> a m E
tuma	t> u m a
botsala	b O ts> a l a
roletseng	r O l E ts> E N
masole	m a s O l E
tlhotlhola	tlh O tlh O l a
gapile	x a p> i l E
thaego	th a E x O
dingwe	d i N w E
mpolelelang	m p> O l E l E l a N
tseneletseng	ts> E n E l E ts> E N
lootsang	l O O ts> a N
nkitse	n k> i ts> E
tsetsweng	ts> E ts> w E N
seipone	s E i p> O n E
ganetsana	x a n E ts> a n a
mouta	m O u t> a
lebota	l E b O t> a
ganetswe	x a n E ts> w E
nyalegile	J a l E x i l E
mmolelela	m m O l E l E l a
ungwang	u N w a N
ithutelang	i th u t> E l a N
laoletswe	l a O l E ts> w E
gatakang	x a t> a k> a N
nthutileng	n th u t> i l E N
meputso	m E p> u ts> O
tsene	ts> E n E
lokologa	l O k> O l O x a
tsagana	ts> a x a n a
dipaka	d i p> a k> a
hotele	h O t> E l E
itlhabolola	i tlh a b O l O l a
disela	d i s E l a
phuthologa	ph u th O l O x a
itsetsepetse	i ts> E ts> E p> E ts> E
enfelopo	E n f E l O p> O
sediba	s E d i b a
popelong	p> O p> E l O N
basireletsi	b a s i r E l E ts> i
ntlentle	n tl> E n tl> E
morutsheng	m O r u tsh E N
kamoganyo	k> a m O x a J O
bakang	b a k> a N
thempereitšhara	th E m p> E r E i tSh a r a
tlhaotsweng	tlh a O ts> w E N
palamiwa	p> a l a m i w a
tsalana	ts> a l a n a
bokotsi	b O k> O ts> i
kgakalanyana	kx a k> a l a J a n a
iphimola	i ph i m O l a
kgethiso	kx E th i s O
tlhamilweng	tlh a m i l w E N
gagola	x a x O l a
kgatlhego	kx a tlh E x O
merwalo	m E r w a l O
bolebeledi	b O l E b E l E d i
itepatepanyeng	i t> E p> a t> E p> a J E N
kgothatswa	kx O th a ts> w a
mabopong	m a b O p> O N
kgatlhang	kx a tlh a N
thutego	th u t> E x O
setela	s E t> E l a
lotsalo	l O ts> a l O
tshwana	tsh w a n a
kgotlatheomolao	kx O tl> a th E O m O l a O
ithutileng	i th u t> i l E N
letlhanetlhane	l E tlh a n E tlh a n E
mathata	m a th a t> a
dipitlagano	d i p> i tl> a x a n O
ikepelang	i k> E p> E l a N
beiwang	b E i w a N
thomeloteng	th O m E l O t> E N
tshwarweng	tsh w a r w E N
setulo	s E t> u l O
dikgotla	d i kx O tl> a
foufala	f O u f a l a
sobokantse	s O b O k> a n ts> E
dikgwebo	d i kx w E b O
tlhaolang	tlh a O l a N
keteketsweng	k> E t> E k> E ts> w E N
masaledi	m a s a l E d i
diboro	d i b O r O
difemeng	d i f E m E N
hirileng	h i r i l E N
ipulele	i p> u l E l E
samente	s a m E n t> E
tshwannwa	tsh w a n n w a
tshetlego	tsh E tl> E x O
polokego	p> O l O k> E x O
gorogang	x O r O x a N
lonkitšhutu	l O n k> i tSh u t> u
ungweng	u N w E N
mpolelele	m p> O l E l E l E
motšhetšhedima	m O tSh E tSh E d i m a
khutshwafaditsweng	kh u tsh w a f a d i ts> w E N
tlhatlhobang	tlh a tlh O b a N
motu	m O t> u
dikaneding	d i k> a n E d i N
gololwa	x O l O l w a
tswalo	ts> w a l O
batsamayakadinao	b a ts> a m a j a k> a d i n a O
diragaletse	d i r a x a l E ts> E
dithefosano	d i th E f O s a n O
dipolao	d i p> O l a O
kumako	k> u m a k> O
tlamelelwa	tl> a m E l E l w a
lesakeng	l E s a k> E N
konoseditsweng	k> O n O s E d i ts> w E N
morwarra	m O r w a r r a
kwadisitswe	k> w a d i s i ts> w E
lebakeng	l E b a k> E N
boalong	b O a l O N
bontshitswe	b O n tsh i ts> w E
faene	f a E n E
bano	b a n O
solofeditse	s O l O f E d i ts> E
kobiso	k> O b i s O
dipeipi	d i p> E i p> i
madiri	m a d i r i
tsheleteng	tsh E l E t> E N
ditsadiso	d i ts> a d i s O
farologaneng	f a r O l O x a n E N
sekgoa	s E kx O a
atlholelwa	a tlh O l E l w a
sala	s a l a
baloi	b a l O i
dutleng	d u tl> E N
makgotlapeomolao	m a kx O tl> a p> E O m O l a O
bodidi	b O d i d i
tsogang	ts> O x a N
ono	O n O
morutabana	m O r u t> a b a n a
kgonagalo	kx O n a x a l O
dikarabo	d i k> a r a b O
ngangisanwang	N a N i s a n w a N
dinageng	d i n a x E N
kutlwisiso	k> u tl> w i s i s O
tironyana	t> i r O J a n a
akanyang	a k> a J a N
ntlhwa	n tlh w a
gakgamaditswe	x a kx a m a d i ts> w E
jwala	d0Z w a l a
tshosiwe	tsh O s i w E
kopilwe	k> O p> i l w E
dipolokelo	d i p> O l O k> E l O
radiong	r a d i O N
sepalaka	s E p> a l a k> a
baakanyetsa	b a k> a J E ts> a
folekese	f O l E k> E s E
kwa	k> w a
pogolo	p> O x O l O
leleka	l E l E k> a
kgakotse	kx a k> O ts> E
kgethisiwa	kx E th i s i w a
mekgatong	m E kx a t> O N
roboto	r O b O t> O
mankwe	m a n k> w E
bolawa	b O l a w a
bolona	b O l O n a
akaretswa	a k> a r E ts> w a
sealogane	s E a l O x a n E
koafala	k> O a f a l a
setorong	s E t> O r O N
ipotse	i p> O ts> E
dimedi	d i m E d i
lekanngwang	l E k> a n N w a N
ngwetsing	N w E ts> i N
takilweng	t> a k> i l w E N
sosobanya	s O s O b a J a
tepatsatsi	t> E p> a ts> a ts> i
tsietsing	ts> i E ts> i N
laisitse	l a i s i ts> E
mekete	m E k> E t> E
potlakileng	p> O tl> a k> i l E N
mmetsa	m m E ts> a
mading	m a d i N
dipuopuo	d i p> u O p> u O
dikgang	d i kx a N
tlhophiweng	tlh O ph i w E N
ditelele	d i t> E l E l E
makgome	m a kx O m E
mmelegisi	m m E l E x i s i
meano	m E a n O
mananeng	m a n a n E N
mabenkele	m a b E n k> E l E
sitsweng	s i ts> w E N
mpho	m ph O
lemosa	l E m O s a
iletsang	i l E ts> a N
tshwaraganela	tsh w a r a x a n E l a
ditshireletso	d i tsh i r E l E ts> O
bareng	b a r E N
rethefala	r E th E f a l a
tlhophetsweng	tlh O ph E ts> w E N
ina	i n a
ipee	i p> E E
tshume	tsh u m E
ralala	r a l a l a
ura	u r a
maroko	m a r O k> O
tlogela	tl> O x E l a
montle	m O n tl> E
tlhatlhelwe	tlh a tlh E l w E
tswelapele	ts> w E l a p> E l E
rarabologelwa	r a r a b O l O x E l w a
mašwi	m a S w i
kgaphetswe	kx a ph E ts> w E
maroka	m a r O k> a
kgaoga	kx a O x a
katolosa	k> a t> O l O s a
tlamuka	tl> a m u k> a
tlwaelesegang	tl> w a E l E S E x a N
leganong	l E x a n O N
okametsweng	O k> a m E ts> w E N
lekwalong	l E k> w a l O N
mafatshe	m a f a tsh E
bokhutshwane	b O kh u tsh w a n E
ngokang	N O k> a N
hempe	h E m p> E
tokofatsa	t> O k> O f a ts> a
tshegeditsweng	tsh E x E d i ts> w E N
tlhatlhetsweng	tlh a tlh E ts> w E N
rulaganye	r u l a x a J E
manyora	m a J O r a
kgopiwa	kx O p> i w a
letsa	l E ts> a
kgothaletsa	kx O th a l E ts> a
katse	k> a ts> E
boetse	b O E ts> E
dintle	d i n tl> E
difudi	d i f u d i
golotse	x O l O ts> E
utlwelelwang	u tl> w E l E l w a N
saenweng	s a E n w E N
modirediloago	m O d i r E d i l O a x O
lewatle	l E w a tl> E
bommasepala	b O m m a s E p> a l a
kagelelo	k> a x E l E l O
dumelelwang	d u m E l E l w a N
morwadio	m O r w a d i O
nyelediweng	J E l E d i w E N
gokelelwa	x O k> E l E l w a
sebui	s E b u i
lolamisa	l O l a m i s a
seemedi	s E E m E d i
boswa	b O s w a
botswelelopele	b O ts> w E l E l O p> E l E
amoge	a m O x E
tshwantse	tsh w a n ts> E
thaladikwe	th a l a d i k> w E
lotso	l O ts> O
ipatlisisa	i p> a tl> i s i s a
bohuma	b O h u m a
bogetse	b O x E ts> E
anetseng	a n E ts> E N
dikotlo	d i k> O tl> O
kgabaganyetsa	kx a b a x a J E ts> a
laletse	l a l E ts> E
rumolega	r u m O l E x a
mogodungwana	m O x O d u N w a n a
kopanela	k> O p> a n E l a
morwaagwe	m O r w a x w E
dikgatiso	d i kx a t> i s O
fitlhile	f i tlh i l E
feleletsang	f E l E l E ts> a N
amogetseng	a m O x E ts> E N
tsenetseng	ts> E n E ts> E N
neile	n E i l E
tlhokofetseng	tlh O k> O f E ts> E N
ditlhagala	d i tlh a x a l a
nayang	n a j a N
humileng	h u m i l E N
mosiane	m O s i a n E
malebogo	m a l E b O x O
kgweetse	kx w E E ts> E
matlhoa	m a tlh O a
dilekanyong	d i l E k> a J O N
fano	f a n O
kganetsanyo	kx a n E ts> a J O
batsomi	b a ts> O m i
phuthego	ph u th E x O
saekholoji	s a E kh O l O d0Z i
thulana	th u l a n a
mantsho	m a n tsh O
nkgopotse	n kx O p> O ts> E
atlhotsweng	a tlh O ts> w E N
kwalelwa	k> w a l E l w a
meletlong	m E l E tl> O N
dipopego	d i p> O p> E x O
theeletsa	th E E l E ts> a
laolela	l a O l E l a
bidiwang	b i d i w a N
sekwaereng	s E k> w a E r E N
khumanegong	kh u m a n E x O N
temogong	t> E m O x O N
bolaile	b O l a i l E
diponalo	d i p> O n a l O
khutleng	kh u tl> E N
babegakgang	b a b E x a kx a N
pelenyana	p> E l E J a n a
sosi	s O s i
rotloediwa	r O tl> O E d i w a
dikgosi	d i kx O s i
dingongoregong	d i N O N O r E x O N
bokwading	b O k> w a d i N
lepile	l E p> i l E
itumelele	i t> u m E l E l E
tlhaelediwa	tlh a E l E d i w a
thapiwe	th a p> i w E
bagarona	b a x a r O n a
marobala	m a r O b a l a
nosetsang	n O s E ts> a N
laisa	l a i s a
tileng	t> i l E N
tlotse	tl> O ts> E
kaenyana	k> a E J a n a
tlhokagala	tlh O k> a x a l a
ditemosi	d i t> E m O s i
tlaletso	tl> a l E ts> O
totšhe	t> O tSh E
tsenyeletsang	ts> E J E l E ts> a N
okaoka	O k> a O k> a
kgamathetseng	kx a m a th E ts> E N
dinnoto	d i n n O t> O
bolokologi	b O l O k> O l O x i
penta	p> E n t> a
fofileng	f O f i l E N
foromong	f O r O m O N
ralebentlele	r a l E b E n tl> E l E
moditšhaba	m O d i tSh a b a
jone	d0Z O n E
golagane	x O l a x a n E
gwetlha	x w E tlh a
segilweng	s E x i l w E N
kagisong	k> a x i s O N
dipolelo	d i p> O l E l O
dijase	d i d0Z a s E
seponono	s E p> O n O n O
dimametlelelo	d i m a m E tl> E l E l O
tswelelelang	ts> w E l E l E l a N
ditshwanetse	d i tsh w a n E ts> E
fekeediwa	f E k> E E d i w a
tlhalositswe	tlh a l O s i ts> w E
dikarateng	d i k> a r a t> E N
ditheong	d i th E O N
tlhomeng	tlh O m E N
legae	l E x a E
motsena	m O ts> E n a
bebofatsa	b E b O f a ts> a
tlhagisiwang	tlh a x i s i w a N
botleleng	b O tl> E l E N
nonofong	n O n O f O N
fitlhisa	f i tlh i s a
manga	m a N a
lomelediwa	l O m E l E d i w a
boeleditse	b O E l E d i ts> E
tliswang	tl> i s w a N
pepentsha	p> E p> E n tsh a
tlhabolo	tlh a b O l O
dibining	d i b i n i N
tshweu	tsh w E u
dikhomphutara	d i kh O m ph u t> a r a
tsenngwang	ts> E n N w a N
tlhatsitse	tlh a ts> i ts> E
gope	x O p> E
sebilo	s E b i l O
tloswa	tl> O s w a
lomapo	l O m a p> O
ipaakanyeditseng	i p> a k> a J E d i ts> E N
bonesitsweng	b O n E s i ts> w E N
bege	b E x E
fetereišene	f E t> E r E i S E n E
seleele	s E l E E l E
ntlhomola	n tlh O m O l a
farologanngwa	f a r O l O x a n N w a
bape	b a p> E
phelegetso	ph E l E x E ts> O
ralalang	r a l a l a N
lebelela	l E b E l E l a
mebedi	m E b E d i
boetsweng	b O E ts> w E N
dikadimong	d i k> a d i m O N
nnile	n n i l E
tobileng	t> O b i l E N
tweng	ts> w E N
rogilwe	r O x i l w E
itshegeditse	i tsh E x E d i ts> E
fokotsega	f O k> O ts> E x a
wela	w E l a
bosenying	b O s E J i N
difefo	d i f E f O
inthanete	i n th a n E t> E
tshwere	tsh w E r E
potsong	p> O ts> O N
tsweledi	ts> w E l E d i
bakgatlhegedi	b a kx a tlh E x E d i
dithweng	d i th w E N
agegileng	a x E x i l E N
sele	s E l E
tlhaloganyege	tlh a l O x a J E x E
iphutha	i ph u th a
berekwa	b E r E k> w a
thekesi	th E k> E s i
nepagalang	n E p> a x a l a N
ntšhwafatsa	n tSh w a f a ts> a
gakgametse	x a kx a m E ts> E
rephaboleki	r E ph a b O l E k> i
tlholegileng	tlh O l E x i l E N
selwelwa	s E l w E l w a
segeng	s E x E N
bothusi	b O th u s i
dirisetsa	d i r i s E ts> a
maitibolo	m a i t> i b O l O
fediswa	f E d i s w a
diboroto	d i b O r O t> O
fetogang	f E t> O x a N
boseng	b O s E N
itshetlega	i tsh E tl> E x a
metseselegaeng	m E ts> E s E l E x a E N
felelang	f E l E l a N
megogoro	m E x O x O r O
nowang	n O w a N
latofadiwe	l a t> O f a d i w E
botlhotlhwa	b O tlh O tlh w a
ele	E l E
ikotlhaya	i k> O tlh a j a
semorafeng	s E m O r a f E N
motlhalerwa	m O tlh a l E r w a
bosetshaba	b O s E tsh a b a
lekalekaneng	l E k> a l E k> a n E N
tharo	th a r O
boidiidi	b O i d i i d i
belaela	b E l a E l a
fetilweng	f E t> i l w E N
mofama	m O f a m a
tlhogela	tlh O x E l a
fofa	f O f a
itlhaganele	i tlh a x a n E l E
bontshiwang	b O n tsh i w a N
modutwaneng	m O d u t> w a n E N
intshitseng	i n tsh i ts> E N
phaposikgwebo	ph a p> O s i kx w E b O
ikopise	i k> O p> i s E
ikuelang	i k> u E l a N
fitlhelela	f i tlh E l E l a
holong	h O l O N
letlalo	l E tl> a l O
je	d0Z E
maloka	m a l O k> a
mothakga	m O th a kx a
bogwata	b O x w a t> a
ditlhakong	d i tlh a k> O N
itlhophetse	i tlh O ph E ts> E
tirelo	t> i r E l O
bogading	b O x a d i N
ipuisetse	i p> u i s E ts> E
tlantsweng	tl> a n ts> w E N
nomoreng	n O m O r E N
patelesege	p> a t> E l E s E x E
fentswe	f E n ts> w E
laeborari	l a E b O r a r i
jona	d0Z O n a
mamina	m a m i n a
bareking	b a r E k> i N
rwesiwa	r w E s i w a
kgonagale	kx O n a x a l E
rewa	r E w a
isiwa	i s i w a
ikarabelang	i k> a r a b E l a N
tirong	t> i r O N
nkga	n kx a
ditsweng	d i ts> w E N
tsela	ts> E l a
kopanngwa	k> O p> a n N w a
letshwaotsiboso	l E tsh w a O ts> i b O s O
tumalano	t> u m a l a n O
gokaganyang	x O k> a x a J a N
sesenyi	s E s E J i
tlholegang	tlh O l E x a N
tlhatlosa	tlh a tl> O s a
tlhagisitseng	tlh a x i s i ts> E N
tsaya	ts> a j a
ntsenya	n ts> E J a
sekgoreletsi	s E kx O r E l E ts> i
boelwe	b O E l w E
setlhareng	s E tlh a r E N
itlela	i tl> E l a
rulagantse	r u l a x a n ts> E
tshitshintsweng	tsh i tsh i n ts> w E N
ketefaletsang	k> E t> E f a l E ts> a N
kopanyeletsa	k> O p> a J E l E ts> a
bothito	b O th i t> O
manya	m a J a
ratanang	r a t> a n a N
aparetswe	a p> a r E ts> w E
gokagantswe	x O k> a x a n ts> w E
dimofatsa	d i m O f a ts> a
dikgatlhegong	d i kx a tlh E x O N
makopanelo	m a k> O p> a n E l O
tlhabe	tlh a b E
tshelanwang	tsh E l a n w a N
ratharatha	r a th a r a th a
totobetsang	t> O t> O b E ts> a N
latelang	l a t> E l a N
moradisi	m O r a d i s i
tshwaragana	tsh w a r a x a n a
botsalo	b O ts> a l O
mafatsheng	m a f a tsh E N
ikatumetse	i k> a t> u m E ts> E
tshololwa	tsh O l O l w a
tlhaselang	tlh a s E l a N
jaka	d0Z a k> a
setona	s E t> O n a
butseng	b u ts> E N
ikanyega	i k> a J E x a
tsenngwe	ts> E n N w E
mabogo	m a b O x O
kotsi	k> O ts> i
kwalo	k> w a l O
kgololo	kx O l O l O
ntlhanngwe	n tlh a n N w E
labone	l a b O n E
moduelalekgetho	m O d u E l a l E kx E th O
motlhong	m O tlh O N
tsamaisiwa	ts> a m a i s i w a
dintsinyana	d i n ts> i J a n a
tlhatlhamang	tlh a tlh a m a N
utlwisisang	u tl> w i s i s a N
metara	m E t> a r a
sethweng	s E th w E N
itheela	i th E E l a
siameng	s i a m E N
borurugo	b O r u r u x O
setofo	s E t> O f O
lebana	l E b a n a
setlhogwana	s E tlh O x w a n a
bosutlha	b O s u tlh a
rebolwa	r E b O l w a
kaela	k> a E l a
bonwe	b O n w E
retologa	r E t> O l O x a
tsweledisa	ts> w E l E d i s a
bonneteng	b O n n E t> E N
kirisi	k> i r i s i
lemosang	l E m O s a N
senolela	s E n O l E l a
neelwa	n E E l w a
bantshi	b a n tsh i
lesika	l E s i k> a
tshasa	tsh a s a
rraarona	r r a r O n a
thibaneng	th i b a n E N
bosaitekanele	b O s a i t> E k> a n E l E
mokone	m O k> O n E
tsweleditse	ts> w E l E d i ts> E
didikerii	d i d i k> E r i i
moruanyi	m O r u a J i
beeletswang	b E E l E ts> w a N
ikaeletseng	i k> a E l E ts> E N
kgaratlhe	kx a r a tlh E
romelwang	r O m E l w a N
dikankere	d i k> a n k> E r E
bolong	b O l O N
etile	E t> i l E
sekisiwe	s E k> i s i w E
ranolwa	r a n O l w a
kokomogo	k> O k> O m O x O
kanwa	k> a n w a
sekgwamana	s E kx w a m a n a
pogiso	p> O x i s O
thutaditso	th u t> a d i ts> O
semowa	s E m O w a
poelothuto	p> O E l O th u t> O
diragatsang	d i r a x a ts> a N
senngwe	s E n N w E
beetswe	b E E ts> w E
ngangisanong	N a N i s a n O N
eletsegeng	E l E ts> E x E N
bonalatsa	b O n a l a ts> a
menape	m E n a p> E
tlhamalalela	tlh a m a l a l E l a
makgotlana	m a kx O tl> a n a
tsentshitswe	ts> E n tsh i ts> w E
dipudulogo	d i p> u d u l O x O
tlameleng	tl> a m E l E N
bagodisi	b a x O d i s i
bapantswe	b a p> a n ts> w E
fetolwang	f E t> O l w a N
tlhodilwe	tlh O d i l w E
mongato	m O N a t> O
dikgobalong	d i kx O b a l O N
solofeditswe	s O l O f E d i ts> w E
thitokgang	th i t> O kx a N
morwaarra	m O r w a r r a
dikela	d i k> E l a
lebeletsweng	l E b E l E ts> w E N
butswang	b u ts> w a N
hupetsa	h u p> E ts> a
bopame	b O p> a m E
ithuta	i th u t> a
dinotshe	d i n O tsh E
bipa	b i p> a
maatlametlo	m a tl> a m E tl> O
diphetogong	d i ph E t> O x O N
tshwara	tsh w a r a
setimi	s E t> i m i
akanyetsa	a k> a J E ts> a
boife	b O i f E
thomelo	th O m E l O
thusitswe	th u s i ts> w E
magae	m a x a E
disenyi	d i s E J i
tshabela	tsh a b E l a
bodumeding	b O d u m E d i N
itlhaganelela	i tlh a x a n E l E l a
tshwarelwang	tsh w a r E l w a N
balelwe	b a l E l w E
dikarabong	d i k> a r a b O N
bonweenwee	b O n w E E n w E E
opelang	O p> E l a N
kgathaleleng	kx a th a l E l E N
thusiwang	th u s i w a N
betla	b E tl> a
ikgonara	i kx O n a r a
baakanngwa	b a k> a n N w a
tlhotlho	tlh O tlh O
tumang	t> u m a N
lolama	l O l a m a
kubediwa	k> u b E d i w a
lobaka	l O b a k> a
gwetlhilwe	x w E tlh i l w E
palogare	p> a l O x a r E
alekhoholo	a l E kh O h O l O
sunetsa	s u n E ts> a
mmatsale	m m a ts> a l E
padi	p> a d i
kgaotse	kx a O ts> E
kgotlhelego	kx O tlh E l E x O
mokawa	m O k> a w a
konegile	k> O n E x i l E
tobetseng	t> O b E ts> E N
kgatlha	kx a tlh a
kutlwalo	k> u tl> w a l O
seralwa	s E r a l w a
karatšheng	k> a r a tSh E N
botagweng	b O t> a x w E N
tlhodiwa	tlh O d i w a
balekgotla	b a l E kx O tl> a
folourung	f O l O u r u N
tlhasela	tlh a s E l a
ipele	i p> E l E
anelang	a n E l a N
bagokaganyi	b a x O k> a x a J i
itshwenya	i tsh w E J a
ragile	r a x i l E
hemang	h E m a N
konsarata	k> O n s a r a t> a
ikgolola	i kx O l O l a
hirisang	h i r i s a N
felegediwa	f E l E x E d i w a
dipotsopotso	d i p> O ts> O p> O ts> O
matswatswa	m a ts> w a ts> w a
bopilweng	b O p> i l w E N
dikang	d i k> a N
maikutlo	m a i k> u tl> O
boutelwa	b O u t> E l w a
gakologelwe	x a k> O l O x E l w E
meetlo	m E E tl> O
itsiseng	i ts> i s E N
mokgatho	m O kx a th O
pato	p> a t> O
kopanetse	k> O p> a n E ts> E
tshwaretswe	tsh w a r E ts> w E
loleme	l O l E m E
bukeng	b u k> E N
dinaledi	d i n a l E d i
kgapetsweng	kx a p> E ts> w E N
swabileng	s w a b i l E N
betologile	b E t> O l O x i l E
tebiso	t> E b i s O
motheong	m O th E O N
tšhoba	tSh O b a
tlhokile	tlh O k> i l E
dikgolaganong	d i kx O l a x a n O N
pheletsong	ph E l E ts> O N
seoposengwe	s E O p> O s E N w E
itomeletsa	i t> O m E l E ts> a
basetsana	b a s E ts> a n a
tlhalosiwang	tlh a l O s i w a N
kgorelediweng	kx O r E l E d i w E N
mmuisanong	m m u i s a n O N
moleofi	m O l E O f i
boitshwarelano	b O i tsh w a r E l a n O
supetse	s u p> E ts> E
tšhono	tSh O n O
dibidio	d i b i d i O
bolamatlhatso	b O l a m a tlh a ts> O
lebelelwa	l E b E l E l w a
ditshwaro	d i tsh w a r O
sokeletsa	s O k> E l E ts> a
selegaeng	s E l E x a E N
tsogelela	ts> O x E l E l a
amela	a m E l a
silegeng	s i l E x E N
ineetseng	i n E E ts> E N
ngoke	N O k> E
difofu	d i f O f u
swetswa	s w E ts> w a
gagole	x a x O l E
etetse	E t> E ts> E
tshositswe	tsh O s i ts> w E
setlhodi	s E tlh O d i
elelediwa	E l E l E d i w a
ditaolelo	d i t> a O l E l O
laletsa	l a l E ts> a
lebitla	l E b i tl> a
ikakanyetse	i k> a k> a J E ts> E
bobedi	b O b E d i
khabetšhe	kh a b E tSh E
kabakanyo	k> a b a k> a J O
mmusakgotla	m m u s a kx O tl> a
ijoo	i d0Z O O
maswati	m a s w a t> i
dumetsweng	d u m E ts> w E N
molomong	m O l O m O N
matlhalosi	m a tlh a l O s i
tumallanong	t> u m a l l a n O N
jase	d0Z a s E
tsamaiso	ts> a m a i s O
tanya	t> a J a
itekantse	i t> E k> a n ts> E
ntšhafatso	n tSh a f a ts> O
lemogiwe	l E m O x i w E
mphitlhela	m ph i tlh E l a
sekaleng	s E k> a l E N
makopanelong	m a k> O p> a n E l O N
lekanngwa	l E k> a n N w a
kampanang	k> a m p> a n a N
dikotsi	d i k> O ts> i
ditlhagiso	d i tlh a x i s O
gatakiwa	x a t> a k> i w a
pitlagana	p> i tl> a x a n a
emisang	E m i s a N
motlhatlhobi	m O tlh a tlh O b i
latlhetseng	l a tlh E ts> E N
sethunya	s E th u J a
rothe	r O th E
bokhukhu	b O kh u kh u
kwakwantela	k> w a k> w a n t> E l a
atile	a t> i l E
dikokomane	d i k> O k> O m a n E
mpotsa	m p> O ts> a
tshameketse	tsh a m E k> E ts> E
tlhwaafalela	tlh w a f a l E l a
lelapeng	l E l a p> E N
itshoka	i tsh O k> a
jalang	d0Z a l a N
filimi	f i l i m i
lokwalotshelo	l O k> w a l O tsh E l O
ditlamorago	d i tl> a m O r a x O
senkele	s E n k> E l E
tshekeletsana	tsh E k> E l E ts> a n a
ditlamela	d i tl> a m E l a
kgogedi	kx O x E d i
ponagalo	p> O n a x a l O
tshotswe	tsh O ts> w E
ditlamelo	d i tl> a m E l O
tshwariwa	tsh w a r i w a
sobokanyang	s O b O k> a J a N
ditulo	d i t> u l O
matlhong	m a tlh O N
siamisiwa	s i a m i s i w a
dipotsong	d i p> O ts> O N
mapodisi	m a p> O d i s i
foreimi	f O r E i m i
elediwang	E l E d i w a N
lepodisi	l E p> O d i s i
tsewang	ts> E w a N
kaneng	k> a n E N
dibodi	d i b O d i
ntsintsi	n ts> i n ts> i
ntwa	n t> w a
mokoro	m O k> O r O
morero	m O r E r O
tshikinyo	tsh i k> i J O
khupamarama	kh u p> a m a r a m a
kotsa	k> O ts> a
kopela	k> O p> E l a
ikopantse	i k> O p> a n ts> E
itietse	i t> i E ts> E
isang	i s a N
thibelang	th i b E l a N
tlopa	tl> O p> a
oborolo	O b O r O l O
tlhagiseng	tlh a x i s E N
abetsweng	a b E ts> w E N
gobetseng	x O b E ts> E N
babalamatlotlo	b a b a l a m a tl> O tl> O
dipegelo	d i p> E x E l O
marulelong	m a r u l E l O N
abela	a b E l a
batlhoki	b a tlh O k> i
silintara	s i l i n t> a r a
fitlheletswe	f i tlh E l E ts> w E
ratela	r a t> E l a
senwelo	s E n w E l O
pako	p> a k> O
sesireletsi	s E s i r E l E ts> i
kerabole	k> E r a b O l E
mainaina	m a i n a i n a
mefuta	m E f u t> a
bosetšhabatšhaba	b O s E tSh a b a tSh a b a
tšhaba	tSh a b a
tlhomamo	tlh O m a m O
ijo	i d0Z O
ikaelele	i k> a E l E l E
mafoko	m a f O k> O
sikologa	s i k> O l O x a
tlhatlhamano	tlh a tlh a m a n O
motaung	m O t> a u N
thulaganyo	th u l a x a J O
moiphemeding	m O i ph E m E d i N
bagaka	b a x a k> a
phatlha	ph a tlh a
thala	th a l a
saenetseng	s a E n E ts> E N
sebele	s E b E l E
itshokelano	i tsh O k> E l a n O
kota	k> O t> a
amang	a m a N
lwelwang	l w E l w a N
mpotse	m p> O ts> E
karolong	k> a r O l O N
diphousetara	d i ph O u s E t> a r a
tshwabong	tsh w a b O N
kabele	k> a b E l E
samorago	s a m O r a x O
hei	h E i
bonalang	b O n a l a N
ditlhaloganyong	d i tlh a l O x a J O N
fulwa	f u l w a
ditlhase	d i tlh a s E
kgatlhegele	kx a tlh E x E l E
nyalanngwang	J a l a n N w a N
dilalelo	d i l a l E l O
bulegetseng	b u l E x E ts> E N
lentshwa	l E n tsh w a
sediredi	s E d i r E d i
nosi	n O s i
robotong	r O b O t> O N
tlhongwa	tlh O N w a
bosading	b O s a d i N
tsweleditswe	ts> w E l E d i ts> w E
bontsing	b O n ts> i N
kokoanyetsa	k> O k> O a J E ts> a
metlhagare	m E tlh a x a r E
latlhegang	l a tlh E x a N
itshwela	i tsh w E l a
diminerala	d i m i n E r a l a
ethimola	E th i m O l a
dithekeniki	d i th E k> E n i k> i
thusiweng	th u s i w E N
difaeleng	d i f a E l E N
magotlo	m a x O tl> O
nomore	n O m O r E
letogo	l E t> O x O
ditleliniki	d i tl> E l i n i k> i
ditshiamiso	d i tsh i a m i s O
dikgora	d i kx O r a
ree	r E E
tlhalana	tlh a l a n a
kuranteng	k> u r a n t> E N
tlhanogetse	tlh a n O x E ts> E
motshetelo	m O tsh E t> E l O
inaakanya	i n a k> a J a
moitshodi	m O i tsh O d i
amogiwa	a m O x i w a
gatetse	x a t> E ts> E
badisi	b a d i s i
dipalelo	d i p> a l E l O
tlola	tl> O l a
gopotsa	x O p> O ts> a
fufegele	f u f E x E l E
mogatsa	m O x a ts> a
amane	a m a n E
ditilo	d i t> i l O
motsenagare	m O ts> E n a x a r E
namatsha	n a m a tsh a
moma	m O m a
mofufutso	m O f u f u ts> O
ditlaleletsi	d i tl> a l E l E ts> i
itlamile	i tl> a m i l E
netefatswa	n E t> E f a ts> w a
ungwela	u N w E l a
gaupanya	x a u p> a J a
lelekileng	l E l E k> i l E N
kilogerama	k> i l O x E r a m a
nole	n O l E
bogareng	b O x a r E N
rokile	r O k> i l E
letlhakore	l E tlh a k> O r E
boitshegang	b O i tsh E x a N
sontageng	s O n t> a x E N
rekisiwe	r E k> i s i w E
megopolo	m E x O p> O l O
putswa	p> u ts> w a
phepafatse	ph E p> a f a ts> E
gololwe	x O l O l w E
sosobana	s O s O b a n a
swela	s w E l a
gae	x a E
tlhabosegang	tlh a b O s E x a N
mosotli	m O s O tl> i
diradio	d i r a d i O
papiso	p> a p> i s O
ikhumisa	i kh u m i s a
sekao	s E k> a O
bogotswana	b O x O ts> w a n a
tlhorisega	tlh O r i s E x a
etsaetsega	E ts> a E ts> E x a
kgalemela	kx a l E m E l a
begelela	b E x E l E l a
totatota	t> O t> a t> O t> a
tena	t> E n a
itiisa	i t> i i s a
lotlega	l O tl> E x a
laelwa	l a E l w a
ikanye	i k> a J E
rebolelwa	r E b O l E l w a
pega	p> E x a
mmogedi	m m O x E d i
ralwa	r a l w a
itematsa	i t> E m a ts> a
moporofesa	m O p> O r O f E s a
tshwantshanya	tsh w a n tsh a J a
tshekong	tsh E k> O N
setshego	s E tsh E x O
laolwe	l a O l w E
mamaretse	m a m a r E ts> E
pitlaganyang	p> i tl> a x a J a N
utolole	u t> O l O l E
itebogela	i t> E b O x E l a
mma	m m a
saena	s a E n a
ditshiamololo	d i tsh i a m O l O l O
apewe	a p> E w E
ntseela	n ts> E E l a
letlang	l E tl> a N
seteropo	s E t> E r O p> O
susu	s u s u
dinyageng	d i J a x E N
masele	m a s E l E
sefata	s E f a t> a
bobone	b O b O n E
kgannyeng	kx a n J E N
ntheye	n th E j E
fetolelang	f E t> O l E l a N
masising	m a s i s i N
baetleetsi	b a E tl> E E ts> i
paki	p> a k> i
bolele	b O l E l E
mmese	m m E s E
ateng	a t> E N
kgakala	kx a k> a l a
mmitara	m m i t> a r a
makoa	m a k> O a
nyalana	J a l a n a
dikinane	d i k> i n a n E
lekanyetsa	l E k> a J E ts> a
malebane	m a l E b a n E
bolaoding	b O l a O d i N
marobalong	m a r O b a l O N
seme	s E m E
khurumetsang	kh u r u m E ts> a N
thibelo	th i b E l O
feke	f E k> E
rone	r O n E
tharaano	th a r a n O
eletsang	E l E ts> a N
timetse	t> i m E ts> E
gogiwang	x O x i w a N
dithumi	d i th u m i
babetli	b a b E tl> i
kapetla	k> a p> E tl> a
welwang	w E l w a N
diresiti	d i r E s i t> i
mebuso	m E b u s O
bolelelwa	b O l E l E l w a
sejanageng	s E d0Z a n a x E N
tswalegile	ts> w a l E x i l E
mpiditse	m p> i d i ts> E
kwaya	k> w a j a
kganeletswe	kx a n E l E ts> w E
utlwiseng	u tl> w i s E N
hupa	h u p> a
tshoswane	tsh O s w a n E
sutisediwa	s u t> i s E d i w a
ikaegeng	i k> a E x E N
dikeledi	d i k> E l E d i
itlhokela	i tlh O k> E l a
matlapa	m a tl> a p> a
opetse	O p> E ts> E
dilemo	d i l E m O
nkapoleng	n k> a p> O l E N
agileng	a x i l E N
bosigogare	b O s i x O x a r E
mmusong	m m u s O N
ikobela	i k> O b E l a
nametsang	n a m E ts> a N
seloko	s E l O k> O
tirisobotlhaswa	t> i r i s O b O tlh a s w a
nokeng	n O k> E N
begelwa	b E x E l w a
dibiri	d i b i r i
fosiwang	f O s i w a N
fapose	f a p> O s E
naka	n a k> a
segongwe	s E x O N w E
itise	i t> i s E
dipoifo	d i p> O i f O
kgathaletsege	kx a th a l E ts> E x E
magale	m a x a l E
runa	r u n a
tlhantlhetse	tlh a n tlh E ts> E
dipholesing	d i ph O l E s i N
nepo	n E p> O
dikopano	d i k> O p> a n O
katlaatlelo	k> a tl> a tl> E l O
dillori	d i l l O r i
dikgoreletsi	d i kx O r E l E ts> i
malomaagwe	m a l O m a x w E
belelang	b E l E l a N
botlhabelong	b O tlh a b E l O N
tlhabololwa	tlh a b O l O l w a
poloto	p> O l O t> O
fetotseng	f E t> O ts> E N
lekhubung	l E kh u b u N
badiramolato	b a d i r a m O l a t> O
letle	l E tl> E
gola	x O l a
fatlhosa	f a tlh O s a
goroga	x O r O x a
metlholo	m E tlh O l O
tilwa	t> i l w a
kgotsofaditswe	kx O ts> O f a d i ts> w E
koketsego	k> O k> E ts> E x O
bojelanala	b O d0Z E l a n a l a
atologile	a t> O l O x i l E
senkgwe	s E n kx w E
rekilweng	r E k> i l w E N
dikampeng	d i k> a m p> E N
ditoro	d i t> O r O
aitsane	a i ts> a n E
tlhapelelwa	tlh a p> E l E l w a
ditshwantshiso	d i tsh w a n tsh i s O
kamotshana	k> a m O tsh a n a
phafaneng	ph a f a n E N
merwalong	m E r w a l O N
kokoantse	k> O k> O a n ts> E
bokhuduthamaga	b O kh u d u th a m a x a
dibaketeria	d i b a k> E t> E r i a
kukega	k> u k> E x a
somerobong	s O m E r O b O N
fisang	f i s a N
ditshenyegelong	d i tsh E J E x E l O N
sedimosiwa	s E d i m O s i w a
tlogang	tl> O x a N
mekwatleng	m E k> w a tl> E N
akeretsa	a k> E r E ts> a
foromane	f O r O m a n E
fedile	f E d i l E
amogeleng	a m O x E l E N
gololesegile	x O l O l E s E x i l E
tidimalo	t> i d i m a l O
gololosege	x O l O l O s E x E
magogorwane	m a x O x O r w a n E
latetse	l a t> E ts> E
boifisang	b O i f i s a N
nwa	n w a
lesetlha	l E s E tlh a
tshegofetse	tsh E x O f E ts> E
sotlakeng	s O tl> a k> E N
itebatsa	i t> E b a ts> a
ranola	r a n O l a
mosoko	m O s O k> O
mojanala	m O d0Z a n a l a
themo	th E m O
motabogi	m O t> a b O x i
kganela	kx a n E l a
tlhagafala	tlh a x a f a l a
dikatiso	d i k> a t> i s O
tsholetswa	tsh O l E ts> w a
diyunibesithing	d i j u n i b E s i th i N
ntsetseng	n ts> E ts> E N
motitiedi	m O t> i t> i E d i
mosimanyana	m O s i m a J a n a
dikabo	d i k> a b O
reeditsweng	r E E d i ts> w E N
utlwisitswe	u tl> w i s i ts> w E
boena	b O E n a
fola	f O l a
tshupantlha	tsh u p> a n tlh a
rwaleng	r w a l E N
thupeng	th u p> E N
bobegadikgang	b O b E x a d i kx a N
bagokaganying	b a x O k> a x a J i N
setlhotlheletsi	s E tlh O tlh E l E ts> i
akanyeditse	a k> a J E d i ts> E
lolamang	l O l a m a N
setlhagisiwa	s E tlh a x i s i w a
tsenelwe	ts> E n E l w E
botlhatlheledi	b O tlh a tlh E l E d i
atolose	a t> O l O s E
fene	f E n E
itlhaganela	i tlh a x a n E l a
manoto	m a n O t> O
gomotse	x O m O ts> E
humanegileng	h u m a n E x i l E N
kgoreletsegang	kx O r E l E ts> E x a N
rekile	r E k> i l E
kolobisitswe	k> O l O b i s i ts> w E
dimilione	d i m i l i O n E
mafelong	m a f E l O N
belegwa	b E l E x w a
reletswe	r E l E ts> w E
okeditsweng	O k> E d i ts> w E N
loetong	l O E t> O N
boetapele	b O E t> a p> E l E
fana	f a n a
dumedise	d u m E d i s E
thopiweng	th O p> i w E N
dumele	d u m E l E
diphaposing	d i ph a p> O s i N
dikomano	d i k> O m a n O
dumelanwe	d u m E l a n w E
kgodisang	kx O d i s a N
gatelelwang	x a t> E l E l w a N
remela	r E m E l a
dipampiri	d i p> a m p> i r i
ikgona	i kx O n a
raraanela	r a r a n E l a
rwele	r w E l E
